word	cluster_name
monarch	Types of people
upland	Transportation?
chair	Types of people
cinder	Objects and things
anglican	More names
exclaim	Valid words
lim	Chinese/asian languages
steven	First names & prop nouns
nicki	First names & prop nouns
rough	Valid words
christi	More names
manila	Objects and things
alia	More names
swarm	Mostly Verbs
sur	European languages
scout	Valid words
set	Mostly Verbs
mobil	More names
paz	European languages
rib	Objects and things
spectra	Sciency words
weather	Valid words
rank	Valid words
utah	First names & prop nouns
worthless	Valid words
coop	Transportation?
lass	Types of people
antic	Valid words
sofa	Transportation?
nico	More names
duke	Mostly Verbs
psych	Sciency words
squash	Valid words
raymond	First names & prop nouns
label	Valid words
dimension	Valid words
steamboat	Transportation?
trier	More names
summon	Mostly Verbs
baron	Types of people
soo	Chinese/asian languages
kayla	More names
guess	Valid words
nape	Objects and things
mojo	Valid words
fallout	Valid words
frontal	Objects and things
stealth	Types of people
bianca	More names
whitney	First names & prop nouns
global	Valid words
chimney	Objects and things
wish	Valid words
redwood	Objects and things
bridget	More names
ty	European languages
brazilian	First names & prop nouns
eduardo	First names & prop nouns
chart	Valid words
prevail	Mostly Verbs
robust	Valid words
bull	Animals
descend	Mostly Verbs
dinosaur	Objects and things
dull	Valid words
moist	Objects and things
sole	Valid words
abbott	More names
construct	Mostly Verbs
tunnel	Transportation?
craft	Transportation?
maui	More names
cao	More names
journal	Valid words
tech	Valid words
unit	Valid words
hometown	Transportation?
deter	Mostly Verbs
tulsa	First names & prop nouns
courtship	Valid words
got	Mostly Verbs
broken	Mostly Verbs
ref	First names & prop nouns
poorer	Transportation?
highest	Valid words
lydia	More names
southeast	Transportation?
warlord	Types of people
gape	Mostly Verbs
techno	Music words
hacker	Sciency words
gild	Objects and things
ec	European languages
sire	Animals
gill	Objects and things
coast	Transportation?
bailey	First names & prop nouns
draper	More names
sec	European languages
heidi	First names & prop nouns
swung	Mostly Verbs
theta	Sciency words
psychic	Sciency words
axel	Objects and things
affection	Valid words
springfield	First names & prop nouns
tier	Objects and things
high	Valid words
cutler	More names
jacob	First names & prop nouns
strauss	More names
museum	Objects and things
piano	Music words
quiver	Valid words
slip	Mostly Verbs
underwear	Objects and things
fist	Valid words
cruz	First names & prop nouns
hast	More names
fiber	Objects and things
manhattan	First names & prop nouns
interpret	Mostly Verbs
hassan	More names
mayor	Valid words
ke	Chinese/asian languages
mediterranean	More names
beak	Objects and things
protein	Sciency words
borrow	Valid words
condor	Animals
from	Valid words
encompass	Mostly Verbs
plaza	Transportation?
glint	Objects and things
valor	Transportation?
dream	Valid words
churn	Mostly Verbs
frontier	Transportation?
helium	Objects and things
if	Valid words
roast	Objects and things
earliest	Valid words
mere	Valid words
torah	Types of people
sir	More names
stale	Valid words
address	Valid words
ang	Chinese/asian languages
so	Valid words
princess	Types of people
cristina	More names
seeker	Types of people
want	Valid words
detriment	Valid words
error	Valid words
site	Valid words
aqueduct	Transportation?
salman	More names
mick	Mostly Verbs
melissa	First names & prop nouns
welterweight	Valid words
skirmish	Valid words
musa	More names
maestro	Valid words
plank	Valid words
signal	Mostly Verbs
lebanon	First names & prop nouns
adult	Types of people
sooner	Valid words
drown	Transportation?
hitter	Valid words
warden	Types of people
ice	Valid words
gymnasium	Transportation?
moreno	More names
godzilla	More names
element	Valid words
inject	Mostly Verbs
cesar	First names & prop nouns
neural	Sciency words
agreement	Valid words
solicitor	Types of people
judaism	More names
wrestler	Valid words
stout	Valid words
sheep	Animals
mag	Valid words
super	Valid words
apex	Valid words
ling	European languages
bermuda	Objects and things
schizophrenia	Sciency words
pascal	First names & prop nouns
marx	More names
hike	Mostly Verbs
promo	Valid words
crescent	Objects and things
coli	Sciency words
yuri	More names
whoever	Valid words
nintendo	Objects and things
could	Valid words
stone	Transportation?
amo	European languages
jill	First names & prop nouns
sunday	First names & prop nouns
canada	First names & prop nouns
paid	Valid words
org	First names & prop nouns
apprenticeship	Valid words
interest	Valid words
carolyn	First names & prop nouns
rupert	More names
dumb	Valid words
haven	Transportation?
pal	Types of people
moss	Objects and things
seoul	More names
limerick	Valid words
your	Valid words
editor	Types of people
rubber	Objects and things
chariot	Transportation?
troop	Transportation?
balloon	Transportation?
view	Valid words
bono	European languages
bled	Objects and things
hid	Types of people
attain	Mostly Verbs
compact	Objects and things
millennia	Types of people
monday	First names & prop nouns
sneak	Mostly Verbs
yoon	Chinese/asian languages
samantha	First names & prop nouns
conform	Mostly Verbs
retrospect	Valid words
thyroid	Sciency words
dancer	Music words
pulp	Objects and things
zeppelin	Transportation?
herself	Types of people
forbidden	Mostly Verbs
ordeal	Valid words
crore	More names
bigger	Valid words
knot	Types of people
overview	Mostly Verbs
monsieur	European languages
gameplay	Objects and things
richard	First names & prop nouns
gown	Objects and things
bao	Chinese/asian languages
hyper	Valid words
extend	Mostly Verbs
swami	More names
chennai	More names
postal	Transportation?
both	Valid words
ri	European languages
atv	More names
che	European languages
rowan	Objects and things
quit	Mostly Verbs
freshman	Valid words
rune	Types of people
novel	Valid words
personnel	Valid words
drastic	Valid words
factual	Sciency words
saturn	More names
sy	European languages
column	Types of people
pepper	Food (ingredients)
scholar	Types of people
fighter	Valid words
potent	Objects and things
coca	Food (ingredients)
lemon	Food (ingredients)
smiley	Valid words
brennan	More names
peak	Valid words
ala	Valid words
marina	Transportation?
shaken	Mostly Verbs
cell	Sciency words
influx	Mostly Verbs
weep	Valid words
proper	Valid words
texan	More names
sunken	Transportation?
get	Mostly Verbs
stronger	Valid words
gentleman	More names
earlier	Valid words
karen	First names & prop nouns
root	Objects and things
phrase	Valid words
brant	Transportation?
reward	Valid words
banda	More names
public	Valid words
gaston	More names
cot	Transportation?
fuss	Valid words
sleeper	Valid words
speak	Valid words
mosaic	Objects and things
epoch	Valid words
rainforest	Transportation?
gymnast	Music words
him	Types of people
scanner	Objects and things
sign	Mostly Verbs
kitten	Animals
malik	More names
teen	Types of people
rebellion	Valid words
ge	European languages
rapper	Types of people
mythic	Valid words
main	Valid words
mccoy	More names
finish	Valid words
bea	European languages
tunic	Objects and things
racism	Types of people
profession	Valid words
murder	Valid words
med	European languages
expand	Mostly Verbs
winnipeg	More names
brink	Valid words
meridian	Sciency words
splendid	Valid words
aboard	Transportation?
carter	First names & prop nouns
shootout	Objects and things
tyler	First names & prop nouns
ruin	Mostly Verbs
conquest	Valid words
job	Valid words
trend	Valid words
lennon	First names & prop nouns
support	Mostly Verbs
suburban	Transportation?
astonish	Mostly Verbs
pregnant	Types of people
surpass	Mostly Verbs
mass	Valid words
shake	Mostly Verbs
judith	More names
ford	European languages
straighten	Mostly Verbs
count	Valid words
julia	First names & prop nouns
bullshit	Valid words
hotel	Transportation?
oath	Valid words
thom	More names
grammar	Valid words
derek	First names & prop nouns
spin	Mostly Verbs
clover	Food (ingredients)
tilt	Mostly Verbs
ambush	Transportation?
lam	Types of people
reg	More names
charleston	First names & prop nouns
martian	Sciency words
taboo	Valid words
collect	Mostly Verbs
corona	Sciency words
volta	European languages
exact	Valid words
bag	Objects and things
jem	More names
born	Types of people
graffiti	Types of people
replica	Valid words
luz	European languages
cake	Food (ingredients)
chieftain	Types of people
feet	Transportation?
accept	Mostly Verbs
falcon	Animals
pu	European languages
herb	Food (ingredients)
metric	Valid words
boston	First names & prop nouns
disk	Objects and things
chelsea	First names & prop nouns
basement	Transportation?
sheath	Objects and things
bae	Chinese/asian languages
schmidt	More names
protest	Valid words
po	European languages
sphere	Valid words
dread	Valid words
symposium	Valid words
tremor	Valid words
rican	More names
report	Valid words
gem	Objects and things
rush	Mostly Verbs
again	Valid words
apart	Valid words
stay	Mostly Verbs
brood	Transportation?
homeland	Transportation?
lopez	First names & prop nouns
scientist	Types of people
ne	European languages
sulfur	Objects and things
vendor	Valid words
art	Objects and things
sparta	More names
peat	Valid words
sim	Objects and things
ariel	Transportation?
quieter	Valid words
loos	Transportation?
giant	Valid words
permit	Valid words
offset	Mostly Verbs
document	Valid words
espn	First names & prop nouns
dwell	Valid words
circular	Objects and things
benjamin	First names & prop nouns
sing	Music words
mention	Valid words
quintet	Valid words
zack	First names & prop nouns
ancestor	Types of people
chamber	Valid words
path	Valid words
audit	Valid words
boxer	Valid words
shred	Mostly Verbs
thong	Objects and things
cruel	Valid words
drag	Mostly Verbs
newton	First names & prop nouns
zoom	Objects and things
choke	Mostly Verbs
gilbert	First names & prop nouns
rapid	Valid words
lynn	First names & prop nouns
victorian	Valid words
attorney	Types of people
trooper	Types of people
thigh	Objects and things
wick	Objects and things
sorrow	Valid words
fda	Sciency words
ibrahim	More names
arctic	Transportation?
lot	Valid words
chest	Objects and things
walter	First names & prop nouns
indian	First names & prop nouns
becker	More names
amsterdam	More names
sore	Sciency words
constrain	Mostly Verbs
julio	More names
russia	First names & prop nouns
kari	More names
shudder	Valid words
particular	Valid words
rack	Valid words
anchor	Valid words
palazzo	Transportation?
disbelief	Valid words
colon	Sciency words
right	Valid words
kiss	Valid words
latin	First names & prop nouns
written	Valid words
gale	Valid words
loki	More names
hade	Valid words
bush	Objects and things
ashton	More names
bud	Objects and things
way	Valid words
brand	Valid words
tax	Valid words
rage	Valid words
sac	Transportation?
archaic	Valid words
venezuela	First names & prop nouns
horsemen	Animals
sidney	More names
equip	Mostly Verbs
conquer	Valid words
joan	First names & prop nouns
stephen	First names & prop nouns
although	Valid words
affect	Mostly Verbs
spec	Valid words
condemn	Types of people
novo	More names
breakout	Valid words
claim	Valid words
call	Valid words
stair	Objects and things
trunk	Transportation?
passion	Valid words
alarm	Valid words
ale	Food (ingredients)
northernmost	Transportation?
contradict	Mostly Verbs
mad	Valid words
hebrew	More names
overthrow	Types of people
room	Transportation?
del	European languages
ronald	More names
moan	Valid words
debt	Valid words
golf	Valid words
jessica	First names & prop nouns
commit	Mostly Verbs
zone	Transportation?
dina	More names
align	Mostly Verbs
linger	Mostly Verbs
aqua	Objects and things
biker	Valid words
stiffen	Mostly Verbs
young	Types of people
shoot	Objects and things
repeat	Mostly Verbs
short	Valid words
grace	Valid words
banquet	Valid words
reverend	Types of people
career	Valid words
info	Valid words
wallet	Objects and things
lambda	Sciency words
embryo	Types of people
indonesia	First names & prop nouns
portray	Mostly Verbs
coin	Valid words
av	European languages
prom	Valid words
kangaroo	Animals
media	Valid words
dive	Mostly Verbs
mock	Valid words
lev	Chinese/asian languages
foolish	Valid words
restart	Mostly Verbs
disney	First names & prop nouns
disappoint	Mostly Verbs
affair	Valid words
ascot	Objects and things
actor	Types of people
bestow	Mostly Verbs
sri	More names
dewey	More names
greg	First names & prop nouns
hernandez	First names & prop nouns
doin	Valid words
mead	Food (ingredients)
patterson	More names
yeshiva	Types of people
sling	Mostly Verbs
adopt	Mostly Verbs
fought	Mostly Verbs
thousand	Valid words
problem	Valid words
larger	Valid words
dine	Food (ingredients)
earnest	Valid words
euro	Valid words
climax	Valid words
daughter	Types of people
bayou	Transportation?
swedish	First names & prop nouns
newborn	Types of people
drake	Transportation?
laugh	Valid words
spartan	Transportation?
regret	Valid words
blown	Mostly Verbs
mystic	Types of people
worst	Valid words
bronx	More names
forget	Valid words
barbarian	Types of people
decker	Transportation?
gradual	Valid words
rand	Valid words
wonderland	Valid words
raj	More names
shadow	Valid words
val	European languages
hair	Objects and things
servant	Types of people
lung	Sciency words
ro	European languages
kern	More names
pond	Transportation?
epithet	Valid words
california	First names & prop nouns
cart	Transportation?
oyster	Animals
heller	More names
yearn	Mostly Verbs
rave	Valid words
maximum	Valid words
colorado	First names & prop nouns
hold	Mostly Verbs
taxi	Transportation?
march	Valid words
ting	European languages
shone	Objects and things
wonder	Valid words
jazz	Music words
rub	Mostly Verbs
ole	More names
vijay	More names
glover	More names
survey	Valid words
coffe	European languages
scenario	Valid words
grid	Valid words
defunct	Valid words
attend	Mostly Verbs
moth	Sciency words
mug	Food (ingredients)
fake	Valid words
tablet	Objects and things
biggest	Valid words
feat	Valid words
bolivar	Valid words
joanna	More names
marquess	Types of people
town	Transportation?
lola	Types of people
faa	More names
therapist	Sciency words
unearth	Mostly Verbs
ipod	Objects and things
prick	Mostly Verbs
canadian	First names & prop nouns
finalist	Valid words
distinct	Valid words
below	Valid words
nick	More names
capita	Valid words
vernon	More names
ganga	More names
hen	Animals
hip	Objects and things
gunner	Transportation?
depress	Mostly Verbs
pitch	Valid words
product	Valid words
kent	First names & prop nouns
outburst	Valid words
waiver	Valid words
ich	European languages
sprint	Valid words
success	Valid words
paint	Objects and things
outpost	Transportation?
guitarist	Music words
unknown	Valid words
hollow	Objects and things
elect	Mostly Verbs
myself	Valid words
pip	Valid words
govt	First names & prop nouns
al	More names
macdonald	More names
ibm	First names & prop nouns
drift	Mostly Verbs
chapman	More names
parish	Types of people
forbid	Mostly Verbs
refer	Valid words
palmer	More names
frighten	Types of people
are	Valid words
fission	Objects and things
some	Valid words
sex	Types of people
peer	Valid words
nausea	Sciency words
gift	Valid words
lump	Objects and things
vicar	Types of people
pratt	More names
leapt	Mostly Verbs
brent	First names & prop nouns
wait	Mostly Verbs
demand	Valid words
grant	Valid words
eureka	Valid words
bald	Types of people
pic	Valid words
wil	Valid words
marcia	More names
roster	Valid words
non	Valid words
dismiss	Mostly Verbs
nice	Valid words
detain	Types of people
lip	Objects and things
provision	Valid words
ao	European languages
reckon	Valid words
mud	Objects and things
jax	More names
begun	Valid words
even	Valid words
wanda	More names
garcia	First names & prop nouns
cafeteria	Transportation?
earl	Types of people
deem	Mostly Verbs
establish	Mostly Verbs
tempo	Valid words
portico	Transportation?
flap	Valid words
atlanta	First names & prop nouns
fossil	Objects and things
trademark	Valid words
nostril	Sciency words
reprint	Valid words
angular	Objects and things
defiant	Valid words
pennsylvania	First names & prop nouns
monica	More names
isi	More names
vibe	Valid words
laurel	Objects and things
temp	Types of people
run	Valid words
skin	Objects and things
orthodox	Types of people
gage	Mostly Verbs
deepen	Mostly Verbs
bruce	First names & prop nouns
fit	Valid words
championship	Valid words
viet	More names
bella	European languages
floyd	First names & prop nouns
talon	Objects and things
unionist	Types of people
regard	Valid words
tung	Chinese/asian languages
nutrient	Sciency words
dod	More names
canyon	Transportation?
jag	Sciency words
maker	Valid words
cond	European languages
pink	Objects and things
ash	Sciency words
courtyard	Transportation?
hallmark	Valid words
sabbath	Types of people
concerto	Music words
bare	Transportation?
lisbon	More names
beat	Valid words
rel	European languages
mel	First names & prop nouns
motorway	Transportation?
might	Valid words
barack	More names
unicorn	Types of people
iso	First names & prop nouns
limb	Objects and things
pension	Valid words
midst	Valid words
yep	Valid words
piss	Mostly Verbs
vol	Sciency words
ravi	More names
cale	More names
fearless	Valid words
mend	Mostly Verbs
stir	Valid words
slit	Objects and things
mint	Food (ingredients)
dylan	First names & prop nouns
orchid	Objects and things
lad	Types of people
rooster	Animals
onion	Food (ingredients)
moral	Valid words
dormant	Valid words
lao	Chinese/asian languages
zac	First names & prop nouns
bree	European languages
yawn	Valid words
ligament	Objects and things
been	Valid words
custom	Mostly Verbs
do	Valid words
mohammad	More names
accent	Valid words
restroom	Transportation?
versa	European languages
guilt	Valid words
rachel	First names & prop nouns
ua	European languages
dame	Types of people
ocean	Transportation?
consult	Mostly Verbs
amen	Types of people
booth	Transportation?
clock	Mostly Verbs
embarrass	Types of people
drum	Objects and things
gave	Mostly Verbs
foley	Valid words
smug	Valid words
stacey	More names
suspend	Mostly Verbs
nora	More names
tan	Objects and things
jun	Chinese/asian languages
prosper	Mostly Verbs
beam	Objects and things
broad	Valid words
alway	European languages
liquid	Objects and things
leonardo	More names
sou	European languages
ascend	Valid words
bullock	Animals
access	Valid words
shiva	Types of people
spread	Valid words
lena	More names
ca	First names & prop nouns
reader	Types of people
stare	Valid words
postwar	Transportation?
succumb	Mostly Verbs
collar	Objects and things
medal	Valid words
dammit	Valid words
rum	Food (ingredients)
stove	Objects and things
endow	Mostly Verbs
wealth	Transportation?
actress	Types of people
slalom	Valid words
andrew	First names & prop nouns
budget	Valid words
sean	First names & prop nouns
leonard	First names & prop nouns
bien	European languages
farmland	Transportation?
umbrella	Valid words
polar	Transportation?
barney	More names
bentley	First names & prop nouns
pete	First names & prop nouns
airship	Transportation?
ferguson	First names & prop nouns
black	Objects and things
diminish	Mostly Verbs
herr	More names
petroleum	Objects and things
perch	Transportation?
lunch	Food (ingredients)
mexico	First names & prop nouns
fish	Animals
symbol	Objects and things
furlong	Animals
meter	Transportation?
theologian	Types of people
caress	Types of people
trouser	Objects and things
council	Valid words
planet	Types of people
flirt	Types of people
pointer	Valid words
stylist	Objects and things
pitcher	Valid words
cornish	First names & prop nouns
voodoo	Types of people
casey	First names & prop nouns
iowa	First names & prop nouns
sho	European languages
pluto	More names
robot	Types of people
heiress	Types of people
amin	European languages
william	First names & prop nouns
covet	Mostly Verbs
shrink	Mostly Verbs
camden	More names
deborah	First names & prop nouns
furious	Valid words
mumbai	More names
liaison	Types of people
chung	Chinese/asian languages
kraft	Objects and things
lesson	Valid words
laptop	Objects and things
ie	Valid words
henderson	First names & prop nouns
at	Valid words
big	Valid words
enlighten	Mostly Verbs
finer	Valid words
highland	Transportation?
northwestern	Transportation?
misunderstood	Valid words
bend	Mostly Verbs
somethin	Valid words
per	Valid words
caesar	European languages
laughter	Valid words
crate	Transportation?
timeless	Valid words
patio	Transportation?
decor	Objects and things
rite	Types of people
co	Valid words
mode	Valid words
punk	Music words
chili	Food (ingredients)
alley	Transportation?
countess	Types of people
younger	Types of people
toledo	More names
featherweight	Valid words
ramp	Transportation?
tucker	More names
etch	Sciency words
disneyland	More names
conflict	Transportation?
behavior	Valid words
cost	Valid words
barefoot	Transportation?
amanda	First names & prop nouns
toilet	Transportation?
grate	Objects and things
piccolo	Music words
rumor	Valid words
surf	Valid words
rice	Food (ingredients)
hang	Mostly Verbs
trainer	Animals
cult	Types of people
answer	Valid words
agrarian	Types of people
plead	Valid words
tempest	Valid words
exhibit	Objects and things
today	Valid words
transport	Transportation?
australian	First names & prop nouns
laser	Objects and things
kicker	Valid words
swear	Valid words
nouveau	European languages
monsoon	Valid words
thud	Valid words
mammal	Animals
easiest	Valid words
hara	More names
xiv	European languages
bonnet	Transportation?
graham	First names & prop nouns
precursor	Valid words
chinatown	More names
violent	Types of people
began	Valid words
quicker	Valid words
candid	Valid words
dash	Mostly Verbs
erupt	Objects and things
fame	Valid words
fuel	Objects and things
hua	Chinese/asian languages
depend	Valid words
porch	Transportation?
cereal	Food (ingredients)
mild	Valid words
buddhist	More names
eighteenth	Valid words
thirteenth	Valid words
nine	Valid words
ace	Valid words
drug	Food (ingredients)
seventeen	Valid words
lust	Valid words
hung	Mostly Verbs
mast	Transportation?
bret	More names
ive	European languages
davenport	Valid words
unitarian	More names
morn	Valid words
harmless	Valid words
reel	Mostly Verbs
district	Transportation?
fargo	More names
dexter	More names
yellow	Objects and things
kan	European languages
hamlet	Transportation?
ten	Valid words
bottom	Valid words
hum	Valid words
liv	European languages
crab	Animals
kick	Valid words
taint	Types of people
blacken	Types of people
spare	Valid words
bey	More names
cow	Animals
woken	Transportation?
breakdown	Valid words
shape	Valid words
premier	Valid words
carla	More names
walt	First names & prop nouns
against	Valid words
cousin	Types of people
internet	Valid words
remark	Valid words
deep	Transportation?
doorway	Transportation?
pendant	Objects and things
ceo	Types of people
quarrel	Valid words
exist	Mostly Verbs
dar	More names
propel	Mostly Verbs
hindu	First names & prop nouns
magnum	Food (ingredients)
poetic	Valid words
six	Valid words
tug	Mostly Verbs
demi	European languages
nueva	European languages
hannah	First names & prop nouns
vanguard	Valid words
ghost	Valid words
albeit	Valid words
steak	Food (ingredients)
jolt	Mostly Verbs
mira	European languages
across	Valid words
lara	First names & prop nouns
archipelago	Transportation?
thi	European languages
vice	Types of people
tangent	Valid words
freighter	Transportation?
wilkinson	More names
ray	Objects and things
hadn	Valid words
class	Objects and things
knight	Types of people
aziz	More names
bari	More names
teaser	Valid words
shouldn	Valid words
pizza	Food (ingredients)
toward	Valid words
shay	European languages
marrow	Sciency words
few	Valid words
ultra	Valid words
swallow	Mostly Verbs
orion	More names
origin	Valid words
hahn	More names
lime	Food (ingredients)
tallest	Transportation?
scuba	Valid words
german	First names & prop nouns
grayson	More names
maureen	Types of people
sheila	More names
accident	Valid words
sage	Valid words
paradox	Valid words
list	Valid words
bubba	More names
fear	Valid words
raja	More names
sort	Valid words
explain	Mostly Verbs
lindsey	First names & prop nouns
est	European languages
popular	Valid words
egypt	First names & prop nouns
velvet	Objects and things
tank	Transportation?
blew	Mostly Verbs
indonesian	More names
except	Valid words
brock	First names & prop nouns
derelict	Objects and things
breakup	Valid words
berg	European languages
roma	First names & prop nouns
form	Valid words
inward	Valid words
watt	Sciency words
lawyer	Types of people
counterattack	Valid words
shen	Chinese/asian languages
mortal	Valid words
blond	Types of people
motor	Transportation?
groom	Types of people
sprung	Mostly Verbs
which	Valid words
bent	Mostly Verbs
brad	First names & prop nouns
wireless	Objects and things
vu	European languages
flow	Mostly Verbs
menu	Food (ingredients)
evelyn	More names
snooker	Valid words
havana	More names
prism	Objects and things
chi	Sciency words
congress	Valid words
cooler	Objects and things
wit	Valid words
taught	Valid words
soap	Objects and things
dump	Mostly Verbs
alicia	More names
hiss	Valid words
sar	More names
nuevo	European languages
submit	Valid words
sponsorship	Valid words
chatter	Valid words
week	Valid words
spiral	Valid words
grain	Food (ingredients)
trailer	Transportation?
craftsmen	Types of people
mal	European languages
accustom	Mostly Verbs
amour	European languages
whitman	More names
mater	Valid words
american	First names & prop nouns
intro	Valid words
header	Valid words
door	Transportation?
advent	Valid words
lar	European languages
chore	Valid words
basin	Transportation?
dal	More names
heather	Transportation?
spring	Valid words
hal	First names & prop nouns
scotch	Food (ingredients)
easter	More names
tuba	Music words
cass	More names
carmel	European languages
malaysia	First names & prop nouns
hong	Chinese/asian languages
futur	More names
correct	Valid words
etc	Valid words
trout	Animals
ep	Valid words
newer	Valid words
punch	Mostly Verbs
brisk	Valid words
buddha	More names
thank	Valid words
journalist	Types of people
za	European languages
chile	Food (ingredients)
reassign	Mostly Verbs
excerpt	Valid words
shop	Transportation?
backward	Valid words
fuck	Valid words
tuck	Mostly Verbs
development	Valid words
op	European languages
ko	Chinese/asian languages
gothic	Music words
deacon	Types of people
comb	Mostly Verbs
burton	First names & prop nouns
meadow	Transportation?
safer	Valid words
propos	European languages
barrett	First names & prop nouns
ode	Valid words
diaz	First names & prop nouns
chet	More names
afraid	Valid words
reclaim	Mostly Verbs
stall	Mostly Verbs
contra	European languages
pay	Valid words
threaten	Mostly Verbs
hitch	Valid words
prey	Transportation?
het	European languages
southwest	Transportation?
sailor	Transportation?
deaf	Valid words
memo	Valid words
bedrock	Valid words
skier	Valid words
won	Valid words
ship	Transportation?
lion	Animals
herbal	Food (ingredients)
neighborhood	Transportation?
ric	European languages
leadership	Valid words
gavin	More names
let	Valid words
interact	Mostly Verbs
doom	Valid words
omaha	First names & prop nouns
anti	Types of people
criteria	Valid words
invert	Valid words
outlaw	Mostly Verbs
waist	Objects and things
northbound	Transportation?
kane	More names
move	Mostly Verbs
plato	More names
warsaw	More names
specialist	Types of people
crater	Sciency words
denim	Objects and things
brook	Transportation?
thin	Mostly Verbs
ark	Types of people
convert	Mostly Verbs
tail	Objects and things
join	Mostly Verbs
store	Transportation?
kathryn	More names
vulcan	More names
rework	Mostly Verbs
absurd	Valid words
norton	First names & prop nouns
christ	First names & prop nouns
leak	Valid words
soprano	Music words
prone	Valid words
benz	More names
bohemian	Transportation?
alt	Music words
mini	Valid words
jeffrey	First names & prop nouns
qin	Chinese/asian languages
find	Valid words
combo	Valid words
bell	Objects and things
largest	Valid words
lush	Transportation?
who	Types of people
west	Transportation?
colt	Animals
thou	Types of people
am	Valid words
takeoff	Transportation?
reset	Mostly Verbs
marlin	Animals
legend	Valid words
philadelphia	First names & prop nouns
dir	European languages
insect	Sciency words
gin	Food (ingredients)
jing	Chinese/asian languages
polo	Valid words
founder	Types of people
block	Mostly Verbs
scrap	Mostly Verbs
sponsor	Valid words
satin	Objects and things
lexington	More names
civil	Transportation?
crash	Valid words
leopard	Animals
oral	Sciency words
combat	Transportation?
holster	Objects and things
downward	Valid words
woman	Types of people
focal	Valid words
amino	Sciency words
twitter	Valid words
port	Transportation?
love	Valid words
undead	Types of people
everest	More names
heavier	Valid words
dick	Valid words
duet	Music words
venom	Objects and things
eighth	Valid words
master	Valid words
fremont	More names
fall	Mostly Verbs
valley	Transportation?
runway	Transportation?
sha	European languages
coincident	Sciency words
homestead	Transportation?
winter	Valid words
algebra	Valid words
lobe	Sciency words
indirect	Valid words
mahal	More names
monaco	More names
foreword	Valid words
duran	More names
impress	Mostly Verbs
eater	Food (ingredients)
bamboo	Objects and things
railroad	Transportation?
venetian	More names
relic	Objects and things
ain	European languages
check	Valid words
tuft	Objects and things
zebra	Animals
rainbow	Objects and things
och	European languages
yen	Valid words
tourist	Transportation?
ak	European languages
rosewood	Objects and things
tariff	Valid words
bedroom	Transportation?
scarlet	Objects and things
campus	Valid words
paperwork	Valid words
gotten	Mostly Verbs
soak	Mostly Verbs
alderman	Valid words
shooter	Objects and things
joke	Valid words
sheng	Chinese/asian languages
republican	Types of people
warp	Valid words
adulthood	Types of people
european	First names & prop nouns
up	Valid words
brig	Types of people
panzer	More names
interceptor	Transportation?
artifact	Objects and things
fabric	Objects and things
cho	Chinese/asian languages
tonga	Transportation?
but	Valid words
weapon	Objects and things
talent	Valid words
envoy	Types of people
crouch	Valid words
cocktail	Food (ingredients)
pew	Transportation?
platform	Valid words
martial	More names
ta	European languages
kevin	First names & prop nouns
catalyst	Valid words
unto	Types of people
creep	Mostly Verbs
bois	European languages
charter	Valid words
ancient	Types of people
lesbian	Types of people
blah	Valid words
yellowish	Objects and things
roach	Animals
nomine	More names
hackney	Transportation?
pea	Food (ingredients)
vanessa	First names & prop nouns
fill	Mostly Verbs
arena	Transportation?
roth	More names
type	Valid words
rafael	More names
micah	More names
commonwealth	Valid words
paula	First names & prop nouns
dogg	First names & prop nouns
pleas	Valid words
filipino	More names
bishop	Types of people
wreath	Objects and things
car	Transportation?
rearview	Transportation?
obama	First names & prop nouns
soviet	First names & prop nouns
sioux	More names
holden	More names
uncertain	Valid words
then	Valid words
kit	Valid words
strife	Valid words
organist	Music words
lyric	Music words
drank	Food (ingredients)
os	First names & prop nouns
beta	Sciency words
gibbon	Animals
calvin	First names & prop nouns
volley	Valid words
trump	Mostly Verbs
tactic	Valid words
reconstruct	Mostly Verbs
deed	Valid words
fascism	Types of people
ton	Valid words
subway	Transportation?
disco	Music words
ruse	Valid words
raid	Valid words
grassland	Transportation?
unleash	Mostly Verbs
possess	Mostly Verbs
mitch	First names & prop nouns
twist	Valid words
homo	Types of people
feather	Objects and things
telecast	Valid words
westward	Transportation?
goddamn	Valid words
jiang	Chinese/asian languages
pad	Objects and things
four	Valid words
well	Valid words
spray	Objects and things
spain	First names & prop nouns
uranium	Objects and things
deng	More names
hop	Mostly Verbs
stainless	Objects and things
uber	Valid words
or	Valid words
back	Valid words
vic	European languages
waitress	Types of people
snuck	Mostly Verbs
gees	More names
classic	Valid words
friar	Types of people
mcgee	First names & prop nouns
shrug	Mostly Verbs
watch	Mostly Verbs
levi	First names & prop nouns
command	Valid words
sonic	Music words
merlin	Transportation?
jodi	More names
knob	Objects and things
owner	Valid words
hoop	Valid words
renault	More names
placement	Valid words
ngo	More names
pinto	European languages
bra	Objects and things
exam	Valid words
fond	Valid words
drench	Mostly Verbs
intact	Valid words
gruff	Valid words
egan	More names
anger	Valid words
sediment	Transportation?
pocket	Objects and things
rear	Transportation?
stanley	First names & prop nouns
australia	First names & prop nouns
obvious	Valid words
duff	More names
hilltop	Transportation?
vega	Sciency words
cal	European languages
tow	More names
zodiac	Sciency words
casa	European languages
brake	Transportation?
eras	Valid words
kiran	More names
fischer	More names
hey	Valid words
conscious	Valid words
sox	First names & prop nouns
lipstick	Objects and things
done	Valid words
ernest	More names
lead	Valid words
hardest	Valid words
perpendicular	Sciency words
premiership	Valid words
church	Types of people
veteran	Types of people
argument	Valid words
fay	European languages
lia	More names
thriller	Valid words
ia	European languages
pencil	Objects and things
blog	Valid words
renal	Sciency words
nectar	Objects and things
orchestra	Music words
shower	Objects and things
tanner	Objects and things
most	Valid words
discreet	Valid words
eyebrow	Objects and things
barber	Types of people
dismount	Objects and things
rubin	More names
tall	Transportation?
tourism	Transportation?
trivial	Valid words
asia	First names & prop nouns
ir	European languages
soar	Mostly Verbs
bluff	Transportation?
reveal	Valid words
metropolitan	Transportation?
scroll	Objects and things
korea	First names & prop nouns
flesh	Mostly Verbs
cite	Valid words
alright	Valid words
offend	Types of people
blurt	Valid words
thick	Mostly Verbs
vigor	Valid words
casino	Valid words
studio	Valid words
crimson	Objects and things
sunk	Transportation?
sweetheart	Types of people
depot	Transportation?
gerard	First names & prop nouns
wooden	Valid words
tuna	Animals
disband	Mostly Verbs
scribe	Types of people
thursday	First names & prop nouns
horror	Valid words
ali	More names
drain	Mostly Verbs
duo	Valid words
fog	Objects and things
frantic	Valid words
cove	Transportation?
height	Valid words
norm	Valid words
bike	Valid words
mood	Valid words
caution	Valid words
oversaw	Mostly Verbs
lunar	Sciency words
floral	Objects and things
creat	Mostly Verbs
workout	Valid words
oklahoma	First names & prop nouns
flock	Mostly Verbs
seen	Valid words
disappear	Mostly Verbs
spot	Valid words
contributor	Types of people
avon	More names
fur	Objects and things
wore	Objects and things
fate	Valid words
bar	Transportation?
ada	More names
never	Valid words
mont	European languages
foil	Mostly Verbs
blogger	Valid words
ma	European languages
stripe	Objects and things
gregg	More names
kickoff	Valid words
reich	First names & prop nouns
rural	Transportation?
xi	European languages
parcel	Transportation?
grandchildren	Types of people
plush	Transportation?
lamp	Objects and things
isaac	More names
pali	More names
sold	Valid words
top	Valid words
dagger	Objects and things
alpha	Sciency words
stanza	Valid words
picnic	Transportation?
chilli	Food (ingredients)
addict	Sciency words
select	Valid words
mathematician	Types of people
meaningless	Valid words
ballet	Music words
kenneth	First names & prop nouns
boil	Objects and things
chaplain	Types of people
cincinnati	First names & prop nouns
palm	Objects and things
swiss	First names & prop nouns
hee	Chinese/asian languages
attack	Valid words
yarn	Objects and things
ag	Food (ingredients)
middleton	More names
sixth	Valid words
ska	Music words
peninsula	Transportation?
sigma	Sciency words
diva	Valid words
legal	Valid words
kate	First names & prop nouns
benson	More names
jay	First names & prop nouns
socialist	Types of people
surveyor	Types of people
bum	Valid words
supervisor	Types of people
reappear	Mostly Verbs
escort	Transportation?
vitamin	Sciency words
pest	Sciency words
sanchez	First names & prop nouns
leg	Objects and things
sphinx	Objects and things
shaft	Transportation?
settler	Types of people
hick	More names
booklet	Valid words
laguna	More names
not	Valid words
digest	Mostly Verbs
experiment	Valid words
sensual	Types of people
cara	European languages
verandah	Transportation?
milano	First names & prop nouns
fled	Transportation?
direct	Valid words
ramsey	First names & prop nouns
chong	Chinese/asian languages
abdomen	Objects and things
annex	Transportation?
squad	Valid words
oil	Objects and things
bracelet	Objects and things
ant	Sciency words
flood	Valid words
bait	Transportation?
worship	Types of people
bone	Objects and things
ground	Valid words
uss	More names
octagon	Valid words
malibu	More names
save	Mostly Verbs
dub	Valid words
true	Valid words
steve	First names & prop nouns
interior	Objects and things
pride	Valid words
playback	Objects and things
homework	Valid words
ortiz	More names
curtain	Transportation?
emma	First names & prop nouns
cube	Objects and things
lash	Mostly Verbs
anal	Types of people
pavilion	Transportation?
graveyard	Transportation?
medial	Sciency words
reaction	Mostly Verbs
cardiovascular	Sciency words
noel	More names
chun	Chinese/asian languages
buy	Valid words
lister	Types of people
reno	Mostly Verbs
auf	European languages
destruct	Mostly Verbs
christina	First names & prop nouns
despair	Valid words
stud	Valid words
batch	Valid words
midland	Valid words
irregular	Types of people
present	Valid words
method	Valid words
arrow	Objects and things
blu	More names
biologist	Types of people
cinema	Valid words
batman	Types of people
street	Transportation?
wen	Chinese/asian languages
anglo	European languages
send	Mostly Verbs
ic	European languages
jar	Food (ingredients)
usher	Mostly Verbs
bearer	Valid words
shannon	First names & prop nouns
grunt	Mostly Verbs
life	Types of people
abbey	Transportation?
babe	Types of people
mack	More names
system	Valid words
flatten	Mostly Verbs
writ	Valid words
mixer	Objects and things
baja	More names
discount	Valid words
refurbish	Mostly Verbs
vi	European languages
haiti	First names & prop nouns
swimmer	Valid words
touchdown	Valid words
ranger	Types of people
bomber	Valid words
trust	Valid words
theorist	Types of people
ley	European languages
vita	European languages
dri	European languages
subset	Valid words
accordion	Music words
field	Valid words
startup	Valid words
internship	Valid words
blanket	Objects and things
rider	Valid words
thorough	Mostly Verbs
booster	Valid words
martinez	First names & prop nouns
burma	More names
judd	More names
month	Valid words
bark	Objects and things
academia	Valid words
mayer	More names
process	Valid words
special	Valid words
national	Valid words
krishna	More names
ze	European languages
sob	Valid words
dwight	First names & prop nouns
guest	Valid words
greer	More names
chicken	Food (ingredients)
titular	Types of people
fast	Valid words
catalan	More names
serious	Valid words
garden	Transportation?
handkerchief	Objects and things
snack	Food (ingredients)
den	Transportation?
gospel	Music words
remix	Music words
hire	Mostly Verbs
relax	Mostly Verbs
petal	Objects and things
nearer	Valid words
cocoa	Food (ingredients)
hour	Valid words
prowess	Valid words
differ	Mostly Verbs
rash	Valid words
copper	Objects and things
withdrawn	Mostly Verbs
bryant	First names & prop nouns
rebecca	First names & prop nouns
forrest	First names & prop nouns
su	European languages
tear	Mostly Verbs
manga	Types of people
auditor	Valid words
five	Valid words
fauna	Transportation?
partnership	Valid words
skull	Objects and things
teacher	Valid words
lightweight	Valid words
tribe	Types of people
server	Objects and things
canning	Food (ingredients)
savior	Valid words
did	Valid words
coke	Objects and things
gonna	Valid words
cellar	Transportation?
desmond	More names
game	Valid words
arson	Valid words
notion	Valid words
poker	Valid words
pollen	Sciency words
brian	First names & prop nouns
behead	Types of people
pill	Sciency words
rooftop	Transportation?
caucasian	More names
wei	Chinese/asian languages
anna	First names & prop nouns
tucson	First names & prop nouns
potion	Types of people
naomi	First names & prop nouns
read	Valid words
beer	Food (ingredients)
humanist	Types of people
dock	Transportation?
barbara	First names & prop nouns
nordic	Valid words
slump	Valid words
via	Valid words
dove	Mostly Verbs
tabloid	Valid words
amar	More names
tower	Transportation?
brace	Mostly Verbs
drawer	Transportation?
brow	Objects and things
waller	More names
cane	Objects and things
thrive	Mostly Verbs
proclaim	Valid words
sway	Mostly Verbs
lantern	Objects and things
ladder	Objects and things
benign	Valid words
dow	European languages
stanford	First names & prop nouns
capitol	Valid words
air	Valid words
se	European languages
bart	More names
crypt	Transportation?
bit	Valid words
trial	Valid words
lea	European languages
terrain	Transportation?
ninja	Types of people
land	Transportation?
rectangular	Objects and things
colonel	Transportation?
entrepreneurship	Valid words
metal	Objects and things
ought	Valid words
dakota	First names & prop nouns
alex	First names & prop nouns
chloe	First names & prop nouns
cartoonist	Valid words
occur	Mostly Verbs
linda	First names & prop nouns
analyst	Types of people
barren	Transportation?
rector	Types of people
taliban	First names & prop nouns
mi	European languages
frost	Valid words
shore	Valid words
hush	Types of people
vortex	Valid words
god	Types of people
patti	More names
behold	Valid words
cough	Sciency words
china	Objects and things
policeman	Transportation?
occult	Types of people
excel	Mostly Verbs
rhythm	Valid words
upset	Valid words
guy	Valid words
countdown	Valid words
oppress	Types of people
close	Valid words
nino	More names
tequila	Food (ingredients)
remind	Mostly Verbs
islam	First names & prop nouns
windsor	More names
lethal	Objects and things
nicola	More names
fountain	Transportation?
picket	Valid words
thumb	Objects and things
alexa	More names
retail	Valid words
bernard	First names & prop nouns
along	Valid words
fetal	Types of people
salem	More names
vocalist	Music words
uk	First names & prop nouns
butch	Types of people
gallon	Objects and things
mora	More names
polka	Music words
horizon	Objects and things
maru	More names
chairman	Types of people
plant	Objects and things
ape	Animals
bala	More names
paisley	Objects and things
kinship	Valid words
made	Valid words
settlement	Valid words
trim	Mostly Verbs
nasa	Chinese/asian languages
she	Types of people
superb	Valid words
may	Valid words
billion	Valid words
secretariat	Valid words
bodyguard	Transportation?
priestess	Types of people
push	Mostly Verbs
paw	Objects and things
condo	Transportation?
joint	Valid words
airmen	Transportation?
distant	Objects and things
alfa	Sciency words
hai	Chinese/asian languages
key	Valid words
keyboard	Objects and things
sit	Mostly Verbs
style	Valid words
zealand	First names & prop nouns
maharaja	Types of people
viewer	Types of people
roundabout	Transportation?
wash	Objects and things
fashion	Objects and things
ii	European languages
prosecutor	Types of people
rat	Animals
angelo	More names
monitor	Mostly Verbs
correspond	Mostly Verbs
flotilla	Transportation?
cheryl	First names & prop nouns
audi	More names
bert	European languages
regain	Mostly Verbs
inspect	Mostly Verbs
chaplin	Types of people
singh	More names
pep	Valid words
martini	Food (ingredients)
pere	European languages
aberdeen	More names
undo	Mostly Verbs
sid	European languages
norwegian	More names
bjorn	More names
leigh	First names & prop nouns
marxist	First names & prop nouns
pitt	First names & prop nouns
firm	Valid words
outlook	Valid words
barrow	Food (ingredients)
hugo	More names
stint	Valid words
blanch	Valid words
usual	Valid words
stand	Mostly Verbs
religion	Types of people
textbook	Valid words
stung	Mostly Verbs
turnout	Valid words
omit	Mostly Verbs
poland	More names
paradigm	Valid words
password	Objects and things
cue	Mostly Verbs
cong	More names
sell	Valid words
northern	Transportation?
willing	Valid words
assent	Valid words
puppet	Valid words
moat	Transportation?
shorten	Mostly Verbs
cosmo	Food (ingredients)
brush	Objects and things
lesion	Sciency words
webber	More names
mana	Types of people
weren	Valid words
tip	Mostly Verbs
freedom	Valid words
spear	Objects and things
fletcher	First names & prop nouns
certain	Valid words
break	Mostly Verbs
kidnap	Types of people
shepherd	Mostly Verbs
enzo	More names
apt	Valid words
clean	Objects and things
planner	Types of people
ip	First names & prop nouns
wing	Valid words
dutch	First names & prop nouns
rei	More names
wheelchair	Objects and things
harvey	First names & prop nouns
gleam	Objects and things
salesman	Valid words
payment	Valid words
vanish	Mostly Verbs
tyson	First names & prop nouns
asthma	Sciency words
discomfort	Valid words
quo	European languages
onward	Valid words
soccer	Valid words
trade	Valid words
haut	More names
wren	Animals
sixteenth	Valid words
role	Valid words
jamaican	More names
core	Valid words
emilio	More names
bride	Types of people
hallway	Transportation?
ye	Types of people
bon	European languages
cad	Types of people
moon	Sciency words
exit	Transportation?
sash	Objects and things
smith	First names & prop nouns
unlock	Mostly Verbs
mia	First names & prop nouns
levin	More names
take	Mostly Verbs
coat	Objects and things
punjabi	More names
daze	Valid words
pluck	Mostly Verbs
sub	Valid words
holloway	More names
az	More names
sculptor	Types of people
finch	Animals
slash	Mostly Verbs
solid	Valid words
ward	Transportation?
tara	First names & prop nouns
allot	Valid words
nostalgia	Valid words
broke	Mostly Verbs
consular	Types of people
strap	Objects and things
pontiac	More names
function	Valid words
amount	Valid words
oscar	First names & prop nouns
singer	Music words
sour	Valid words
orgasm	Types of people
resent	Valid words
rue	European languages
brightest	Objects and things
wheeler	Transportation?
mill	Objects and things
vacant	Objects and things
baxter	More names
fresh	Mostly Verbs
wiener	Food (ingredients)
absorb	Mostly Verbs
tenor	Music words
deepest	Transportation?
romanian	More names
anton	More names
farther	Valid words
victor	Valid words
samba	Music words
howard	First names & prop nouns
plateau	Valid words
lavish	Transportation?
throughout	Valid words
fifteen	Valid words
utmost	Valid words
coliseum	Transportation?
stan	European languages
curriculum	Valid words
bane	Valid words
greet	Valid words
creed	Valid words
alphabet	Valid words
inhabit	Mostly Verbs
bliss	Valid words
miguel	First names & prop nouns
sanction	Mostly Verbs
madrid	First names & prop nouns
mosquito	Sciency words
dec	European languages
asleep	Transportation?
mellon	More names
kerr	More names
atheist	Types of people
ring	Objects and things
spatial	Sciency words
villa	Transportation?
silicon	Sciency words
transmit	Mostly Verbs
reagan	First names & prop nouns
depart	Mostly Verbs
shipment	Valid words
slug	Mostly Verbs
gray	Objects and things
nam	Chinese/asian languages
end	Valid words
what	Valid words
deal	Valid words
shotgun	Objects and things
elisa	More names
fallen	Mostly Verbs
frenchman	More names
memorabilia	Objects and things
indo	More names
crunch	Valid words
soloist	Music words
adept	Valid words
hana	More names
ronin	Types of people
slept	Transportation?
trillion	Valid words
color	Objects and things
wal	More names
gandhi	More names
lloyd	First names & prop nouns
feedback	Mostly Verbs
sonar	Animals
asphalt	Objects and things
liver	Sciency words
sun	Objects and things
honolulu	More names
loser	Valid words
baltic	More names
author	Types of people
cover	Mostly Verbs
sure	Valid words
sakura	More names
ici	European languages
war	Transportation?
sane	Valid words
had	Valid words
aroma	Objects and things
ellen	First names & prop nouns
uc	First names & prop nouns
bastion	Transportation?
journey	Valid words
ama	More names
katrina	First names & prop nouns
vishnu	More names
spruce	Objects and things
one	Valid words
aren	Valid words
ka	Chinese/asian languages
pedestrian	Transportation?
lighter	Valid words
sear	Objects and things
honeymoon	Types of people
crew	Transportation?
precinct	Transportation?
redevelop	Mostly Verbs
export	Valid words
civic	Valid words
squat	Mostly Verbs
argentina	First names & prop nouns
coaster	Transportation?
traction	Valid words
backdrop	Valid words
foremost	Valid words
ventura	More names
oven	Objects and things
handbook	Valid words
eden	More names
communion	Types of people
nationalist	Types of people
mermaid	Types of people
coven	Types of people
flint	Objects and things
myth	Valid words
rather	Valid words
unseen	Valid words
jena	More names
await	Mostly Verbs
madden	Objects and things
holder	Valid words
gateway	Transportation?
nak	More names
hussain	More names
alla	European languages
pillar	Valid words
ban	Mostly Verbs
how	Valid words
tak	European languages
chaotic	Valid words
hound	Animals
porn	Types of people
burr	Mostly Verbs
tale	Valid words
mickey	Mostly Verbs
enrich	Mostly Verbs
serena	More names
descent	Valid words
publish	Valid words
archer	Objects and things
vo	European languages
fool	Mostly Verbs
woodland	Transportation?
inhibitor	Sciency words
weaken	Mostly Verbs
later	Valid words
cortex	Sciency words
ego	Valid words
tension	Valid words
tree	Objects and things
fusion	Valid words
ac	European languages
cyclist	Valid words
devout	Types of people
crisp	Valid words
persian	More names
caravan	Transportation?
burden	Valid words
letterman	Valid words
vinci	More names
laura	First names & prop nouns
roosevelt	More names
enthusiasm	Valid words
allison	First names & prop nouns
pandora	More names
hybrid	Valid words
synod	Types of people
thought	Valid words
cork	Objects and things
selfish	Valid words
lowland	Transportation?
pamela	First names & prop nouns
harbor	Transportation?
near	Valid words
garrett	First names & prop nouns
doug	First names & prop nouns
julian	First names & prop nouns
dynamo	Valid words
isa	European languages
sax	Music words
ethic	Valid words
met	Valid words
eun	Chinese/asian languages
natal	Types of people
ding	Valid words
fingerprint	Objects and things
affluent	Transportation?
shovel	Objects and things
huntington	First names & prop nouns
workshop	Valid words
salt	Sciency words
focus	Valid words
freight	Transportation?
tho	European languages
cautious	Valid words
supplement	Mostly Verbs
cuban	First names & prop nouns
year	Valid words
jake	Transportation?
mimi	More names
devil	Types of people
regiment	Transportation?
font	Valid words
dart	Objects and things
intend	Valid words
muhammad	More names
jamal	More names
baseman	Valid words
song	Music words
bed	Transportation?
arthur	First names & prop nouns
grape	Food (ingredients)
dave	First names & prop nouns
sag	Mostly Verbs
polish	Objects and things
cairo	First names & prop nouns
diego	First names & prop nouns
amidst	Valid words
subterranean	Transportation?
gossip	Valid words
buick	More names
southern	Transportation?
hayden	First names & prop nouns
appear	Valid words
clash	Valid words
archangel	Types of people
yao	Chinese/asian languages
ewe	Animals
nay	More names
nina	Chinese/asian languages
panama	More names
vineyard	Food (ingredients)
camp	Valid words
respond	Mostly Verbs
pac	First names & prop nouns
pharaoh	Types of people
tell	Valid words
britain	First names & prop nouns
prophet	Types of people
aldo	More names
teresa	More names
marian	More names
simulcast	Valid words
enigma	Valid words
grief	Valid words
superior	Valid words
shale	Transportation?
wheat	Food (ingredients)
edison	More names
doo	European languages
clung	Mostly Verbs
fantasia	Valid words
lark	Valid words
strung	Mostly Verbs
oder	European languages
akbar	More names
scorpion	Animals
xiang	Chinese/asian languages
upstream	Transportation?
racetrack	Valid words
painter	Types of people
glider	Transportation?
wight	More names
sever	Mostly Verbs
spite	Valid words
video	Valid words
me	Valid words
go	Mostly Verbs
snout	Objects and things
lagoon	Transportation?
gloom	Valid words
harper	First names & prop nouns
ballroom	Transportation?
feed	Mostly Verbs
pace	Valid words
crack	Mostly Verbs
crop	Food (ingredients)
intersect	Valid words
meaning	Valid words
protagonist	Types of people
test	Valid words
midway	Valid words
gong	Valid words
mata	More names
satan	Types of people
counterpart	Valid words
wharf	Transportation?
petrol	Objects and things
bladder	Sciency words
sai	More names
fare	Valid words
ce	European languages
char	Objects and things
upon	Valid words
sugar	Food (ingredients)
disc	Objects and things
robinson	First names & prop nouns
ivan	More names
patent	Valid words
heaviest	Valid words
reborn	Valid words
turf	Objects and things
ass	Valid words
hungarian	More names
io	European languages
shortstop	Valid words
kabul	More names
allow	Valid words
bumper	Transportation?
arbor	Transportation?
cruiser	Types of people
lego	More names
squeal	Valid words
enthusiast	Types of people
loyalist	Types of people
brett	First names & prop nouns
ot	European languages
boca	More names
carver	Types of people
baptist	Types of people
freeway	Transportation?
question	Valid words
milan	First names & prop nouns
sail	Transportation?
relentless	Valid words
aka	Valid words
yer	Valid words
cement	Objects and things
paper	Objects and things
lifeless	Valid words
striker	Valid words
should	Valid words
limo	Transportation?
hess	More names
jung	Chinese/asian languages
tin	More names
keep	Mostly Verbs
klein	First names & prop nouns
cave	Transportation?
midtown	Transportation?
chilean	More names
away	Valid words
nova	Sciency words
start	Valid words
yourself	Valid words
variant	Valid words
persia	More names
triumphant	Valid words
asa	European languages
depict	Mostly Verbs
emperor	Types of people
bombay	More names
anterior	Sciency words
erica	First names & prop nouns
lyon	More names
recur	Mostly Verbs
belt	Objects and things
regress	Mostly Verbs
lore	Valid words
manor	Transportation?
elena	More names
cipher	Valid words
homeless	Transportation?
underworld	Types of people
zero	Valid words
linear	Sciency words
dam	Transportation?
ix	European languages
southeastern	Transportation?
reservoir	Transportation?
torso	Objects and things
blank	Objects and things
trough	Valid words
peruvian	More names
stick	Mostly Verbs
fred	First names & prop nouns
chosen	Valid words
vast	Valid words
rain	Valid words
hitler	First names & prop nouns
paler	Valid words
sister	Types of people
squadron	Transportation?
heighten	Mostly Verbs
chihuahua	Animals
driveway	Transportation?
ya	Valid words
spend	Mostly Verbs
brew	Food (ingredients)
slid	Mostly Verbs
lutheran	More names
barrel	Objects and things
formal	Valid words
medium	Valid words
austrian	More names
eri	More names
sweeney	More names
fife	More names
director	Types of people
file	Valid words
ursula	More names
forward	Valid words
splash	Mostly Verbs
demo	Valid words
sank	Transportation?
slap	Mostly Verbs
damon	More names
playboy	Types of people
iq	First names & prop nouns
packet	Objects and things
sa	Chinese/asian languages
code	Valid words
still	Valid words
facto	European languages
kamal	More names
gareth	More names
medley	Music words
spell	Valid words
alien	Types of people
bradley	First names & prop nouns
riff	Valid words
attest	Mostly Verbs
eileen	More names
night	Valid words
regardless	Valid words
droplet	Objects and things
oh	Valid words
dude	Valid words
hue	Objects and things
quartet	Valid words
magician	Valid words
vault	Valid words
fail	Mostly Verbs
sprawl	Transportation?
slate	Valid words
provost	Types of people
turk	More names
program	Valid words
kyoto	More names
display	Valid words
weir	Transportation?
brothel	Types of people
crime	Types of people
vet	Animals
intern	Valid words
ken	European languages
covert	Types of people
shove	Mostly Verbs
gearbox	Transportation?
requiem	Valid words
mo	European languages
cash	Valid words
shire	Transportation?
eject	Types of people
camel	Animals
reddish	Objects and things
clarinet	Music words
annual	Valid words
psycho	Sciency words
retract	Types of people
dockyard	Transportation?
resist	Mostly Verbs
ach	European languages
baton	Objects and things
louie	More names
wadi	Transportation?
brawl	Valid words
cope	Mostly Verbs
yi	Chinese/asian languages
leon	First names & prop nouns
denis	First names & prop nouns
maynard	First names & prop nouns
crucial	Valid words
preschool	Valid words
streak	Valid words
liner	Objects and things
fri	European languages
medic	Transportation?
orbit	Sciency words
stereo	Objects and things
gate	Transportation?
hit	Mostly Verbs
chose	Valid words
thug	Types of people
turkish	More names
seem	Valid words
basal	Sciency words
built	Mostly Verbs
ax	Objects and things
plaid	Objects and things
joy	Valid words
forgotten	Valid words
front	Valid words
kurt	First names & prop nouns
newark	More names
pseudo	Valid words
amongst	Valid words
cai	Chinese/asian languages
john	First names & prop nouns
footprint	Valid words
welch	European languages
istanbul	More names
glide	Mostly Verbs
hewitt	More names
smack	Mostly Verbs
whisper	Valid words
convent	Types of people
regent	Types of people
need	Valid words
flew	Transportation?
chrome	Objects and things
mane	Objects and things
pillow	Transportation?
last	Valid words
assess	Mostly Verbs
kindergarten	Valid words
ste	European languages
beneath	Valid words
kuwait	First names & prop nouns
una	European languages
hint	Valid words
processor	Sciency words
long	Valid words
scowl	Valid words
medallion	Valid words
curl	Mostly Verbs
likelihood	Valid words
marley	More names
queer	Types of people
sebastian	More names
scarf	Objects and things
picker	Food (ingredients)
fastest	Valid words
mayo	Food (ingredients)
anya	More names
sniff	Mostly Verbs
goat	Animals
fir	Objects and things
paramount	Valid words
zheng	Chinese/asian languages
blade	Objects and things
least	Valid words
brutal	Valid words
rhythmic	Valid words
mammoth	Valid words
chestnut	Objects and things
kemp	More names
incur	Mostly Verbs
unpaid	Valid words
pursuit	Valid words
packer	Food (ingredients)
silver	Objects and things
handheld	Objects and things
grin	Valid words
cypress	Objects and things
brown	Objects and things
link	Mostly Verbs
thor	More names
pepsi	European languages
overheard	Valid words
shan	Chinese/asian languages
gall	Mostly Verbs
yeah	Valid words
dialect	Valid words
bicep	Objects and things
shot	Objects and things
grow	Mostly Verbs
rigid	Valid words
policemen	Transportation?
visitor	Valid words
come	Mostly Verbs
glue	Objects and things
flicker	Objects and things
pre	Valid words
powder	Objects and things
orchard	Food (ingredients)
quick	Valid words
leather	Objects and things
qu	European languages
conscript	Transportation?
held	Mostly Verbs
rein	Mostly Verbs
wong	Chinese/asian languages
sahib	More names
peng	Chinese/asian languages
muse	Types of people
titanium	Objects and things
saturday	First names & prop nouns
erika	More names
perth	First names & prop nouns
hurley	More names
extant	Valid words
laurent	More names
bonus	Valid words
thrill	Valid words
girl	Types of people
fitzgerald	More names
ridden	Valid words
sang	Music words
knock	Mostly Verbs
joe	First names & prop nouns
suck	Mostly Verbs
dog	Animals
activist	Types of people
ing	European languages
overlap	Valid words
infer	Mostly Verbs
suffer	Mostly Verbs
carbon	Objects and things
om	European languages
shane	First names & prop nouns
alec	More names
hot	Objects and things
icon	Valid words
saliva	Sciency words
gland	Sciency words
fraud	Types of people
gum	Food (ingredients)
tubular	Objects and things
knick	More names
ranch	Transportation?
iranian	First names & prop nouns
pantheon	Valid words
jia	Chinese/asian languages
japan	First names & prop nouns
exempt	Mostly Verbs
sheer	Valid words
patricia	First names & prop nouns
bass	Animals
spaniard	More names
parapet	Transportation?
soy	Food (ingredients)
rehab	Sciency words
mac	First names & prop nouns
chew	Mostly Verbs
mart	Transportation?
handicap	Valid words
own	Valid words
arlington	More names
dat	European languages
various	Valid words
wai	Chinese/asian languages
fiscal	Valid words
opinion	Valid words
ear	Objects and things
stress	Valid words
ore	Objects and things
sent	Mostly Verbs
mosh	Music words
washington	First names & prop nouns
freak	Valid words
behalf	Valid words
pun	Valid words
union	Valid words
kong	Chinese/asian languages
greek	Valid words
sao	More names
infect	Sciency words
hind	Objects and things
fraction	Valid words
prefect	Types of people
phenomena	Valid words
jaw	Objects and things
pamphlet	Valid words
labor	Valid words
airway	Sciency words
bleed	Objects and things
vertex	Sciency words
dawn	Objects and things
causal	Sciency words
unclear	Valid words
cole	First names & prop nouns
fine	Valid words
analog	Objects and things
communist	Types of people
evict	Types of people
betray	Types of people
typhoon	Valid words
breath	Mostly Verbs
consent	Valid words
lit	Objects and things
todd	First names & prop nouns
conway	More names
spars	Mostly Verbs
chef	Food (ingredients)
upload	Objects and things
chandra	More names
proven	Valid words
punjab	More names
dian	More names
munich	More names
hazel	Objects and things
lori	First names & prop nouns
they	Valid words
cade	More names
warrant	Valid words
undertook	Mostly Verbs
amid	Valid words
spoken	Valid words
pipe	Objects and things
democrat	Types of people
portland	First names & prop nouns
wrist	Objects and things
grill	Objects and things
cyclic	Sciency words
syria	First names & prop nouns
fatal	Valid words
tray	Food (ingredients)
wall	Transportation?
sami	More names
neglect	Types of people
shaun	First names & prop nouns
greenish	Objects and things
connor	More names
draft	Valid words
iraq	First names & prop nouns
alta	European languages
ciudad	European languages
ethan	More names
trojan	Sciency words
hooker	Valid words
castro	First names & prop nouns
charley	More names
il	European languages
random	Sciency words
sutra	More names
minimum	Valid words
threw	Mostly Verbs
plaintiff	Valid words
mohawk	Objects and things
exterior	Objects and things
encyclopedia	Valid words
xvi	European languages
rampant	Valid words
suburb	Transportation?
bulk	Valid words
choreograph	Valid words
venezuelan	More names
helm	Types of people
honey	Food (ingredients)
ina	European languages
than	Valid words
vein	Transportation?
morrow	Valid words
watson	First names & prop nouns
speaker	Valid words
trash	Objects and things
seminar	Valid words
stride	Mostly Verbs
nirvana	Valid words
bison	Animals
boardwalk	Transportation?
snort	Mostly Verbs
xiao	Chinese/asian languages
distract	Types of people
sanford	More names
kilogram	Objects and things
abduct	Types of people
lieu	Valid words
melt	Objects and things
banner	Objects and things
hook	Mostly Verbs
fascist	Types of people
walkway	Transportation?
sato	More names
goodman	More names
hug	Valid words
butcher	Types of people
drought	Valid words
snow	Valid words
fee	Valid words
coal	Objects and things
spaghetti	Food (ingredients)
carl	First names & prop nouns
folk	Music words
smooth	Valid words
minnesota	First names & prop nouns
bobo	More names
flee	Transportation?
thermal	Objects and things
snatch	Mostly Verbs
daylight	Objects and things
african	First names & prop nouns
sultan	Types of people
instinct	Valid words
fore	Valid words
though	Valid words
withstand	Mostly Verbs
pant	Objects and things
township	Transportation?
nebraska	First names & prop nouns
santo	European languages
knox	More names
jam	Music words
movement	Valid words
novak	More names
fuse	Objects and things
neal	First names & prop nouns
stray	Mostly Verbs
corps	Valid words
diesel	Objects and things
def	European languages
rita	More names
period	Valid words
amass	Mostly Verbs
hollywood	First names & prop nouns
meteor	Sciency words
breast	Sciency words
slow	Valid words
wire	Objects and things
crotch	Valid words
sweet	Valid words
cameron	First names & prop nouns
noir	Music words
base	Valid words
scott	First names & prop nouns
disgust	Valid words
hilton	First names & prop nouns
outta	Valid words
jen	Chinese/asian languages
road	Transportation?
reach	Mostly Verbs
account	Valid words
sui	European languages
seldom	Valid words
egyptian	More names
slant	Valid words
wept	Valid words
admit	Valid words
induct	Mostly Verbs
arroyo	Transportation?
indigo	Objects and things
lineman	Valid words
fold	Valid words
squeak	Valid words
historian	Types of people
ferdinand	First names & prop nouns
panorama	Objects and things
tehran	More names
snap	Mostly Verbs
scorer	Valid words
came	Mostly Verbs
baptism	Types of people
scoop	Mostly Verbs
ren	Chinese/asian languages
buster	Mostly Verbs
marshal	Types of people
carmen	More names
pioneer	Types of people
bowman	Transportation?
atm	European languages
kia	More names
pray	Types of people
mistaken	Valid words
peacock	Animals
alabama	First names & prop nouns
sustain	Mostly Verbs
mose	More names
pursuant	Valid words
pearl	Objects and things
pounder	Transportation?
adrenalin	Valid words
lucha	First names & prop nouns
equestrian	Valid words
cod	Animals
plump	Mostly Verbs
hood	Transportation?
race	Valid words
webb	First names & prop nouns
jose	First names & prop nouns
poem	Valid words
idiot	Valid words
death	Valid words
weight	Sciency words
nor	Valid words
margaret	First names & prop nouns
facebook	Valid words
platoon	Transportation?
yamaha	More names
ledger	Valid words
feast	Valid words
tor	European languages
endeavor	Valid words
dee	European languages
apollo	More names
vision	Valid words
ira	European languages
multimedia	Objects and things
scale	Valid words
mari	More names
dia	European languages
destroy	Mostly Verbs
pyramid	Objects and things
frankenstein	More names
dyke	Transportation?
brandon	First names & prop nouns
filter	Mostly Verbs
arun	More names
divert	Mostly Verbs
spacecraft	Sciency words
vulgar	Valid words
london	First names & prop nouns
louis	First names & prop nouns
mri	More names
kept	Mostly Verbs
when	Valid words
kramer	More names
stiff	Valid words
hysteria	Valid words
cartoon	Valid words
tram	Transportation?
shine	Objects and things
garment	Objects and things
wolf	Animals
xiii	European languages
sen	Valid words
diplomat	Types of people
transcript	Valid words
mole	Types of people
upbeat	Valid words
gear	Valid words
strait	Transportation?
dom	Valid words
runaway	Valid words
subsist	Mostly Verbs
bangkok	More names
dna	Objects and things
idea	Valid words
linguist	Types of people
caliph	Types of people
wage	Valid words
raul	First names & prop nouns
sol	Sciency words
target	Valid words
tenant	Valid words
spun	Mostly Verbs
bloom	Mostly Verbs
michael	First names & prop nouns
welsh	More names
sin	Types of people
stuart	First names & prop nouns
berger	More names
marijuana	Food (ingredients)
mix	Valid words
drone	Transportation?
membership	Valid words
botanist	Types of people
inspector	Types of people
age	Types of people
michel	More names
southernmost	Transportation?
keeper	Valid words
smackdown	Valid words
tamil	More names
backseat	Valid words
nonprofit	Valid words
stalker	Types of people
quiz	Valid words
pass	Mostly Verbs
greenwood	More names
re	Valid words
download	Objects and things
froze	Valid words
trigger	Mostly Verbs
cora	More names
manuscript	Valid words
georgia	First names & prop nouns
nash	First names & prop nouns
uno	European languages
tape	Valid words
toro	European languages
swore	Valid words
about	Valid words
roberto	First names & prop nouns
eva	First names & prop nouns
reza	More names
ata	European languages
smash	Mostly Verbs
stalk	Mostly Verbs
dent	Mostly Verbs
telegraph	Transportation?
floor	Transportation?
fluid	Objects and things
meg	Objects and things
tam	First names & prop nouns
banco	European languages
shankar	More names
fallon	More names
word	Valid words
congressman	Valid words
negro	More names
yet	Valid words
frontman	Music words
tate	European languages
feminist	Types of people
quilt	Objects and things
barley	Food (ingredients)
atom	Sciency words
parrot	Animals
electron	Sciency words
luke	First names & prop nouns
pari	European languages
midnight	Valid words
boulder	Transportation?
brownish	Objects and things
drunk	Food (ingredients)
glass	Transportation?
beast	Types of people
slower	Valid words
local	Valid words
draw	Mostly Verbs
flinch	Valid words
atari	First names & prop nouns
their	Valid words
russ	First names & prop nouns
tuition	Valid words
team	Valid words
mid	Valid words
cream	Food (ingredients)
segment	Valid words
thread	Valid words
mountain	Transportation?
dorset	More names
season	Valid words
berkeley	First names & prop nouns
superhero	Types of people
wink	Valid words
bollywood	More names
barton	First names & prop nouns
soft	Valid words
scare	Types of people
rode	Valid words
concern	Valid words
think	Valid words
monster	Types of people
podcast	Valid words
ku	Chinese/asian languages
rip	Mostly Verbs
cent	Valid words
shi	Chinese/asian languages
lok	More names
vamp	Types of people
dinner	Food (ingredients)
algorithm	Sciency words
underway	Valid words
shriek	Valid words
free	Valid words
fix	Mostly Verbs
authorship	Valid words
switzerland	More names
contain	Mostly Verbs
volvo	More names
raf	More names
hive	Sciency words
chuck	Mostly Verbs
meet	Valid words
spectral	Sciency words
oro	European languages
brief	Valid words
scot	More names
priesthood	Types of people
doi	Chinese/asian languages
session	Valid words
arcadia	Valid words
magna	European languages
brave	Valid words
der	European languages
florida	First names & prop nouns
alison	More names
ying	Chinese/asian languages
duchess	Types of people
ter	European languages
nod	Valid words
pupil	Valid words
hawthorn	Objects and things
flute	Music words
eighteen	Valid words
marc	First names & prop nouns
nana	Types of people
meta	Sciency words
crystal	Objects and things
foyer	Transportation?
gerald	More names
shanghai	More names
dino	Objects and things
mate	Types of people
lucia	More names
pole	Valid words
ji	More names
brethren	Valid words
mohan	More names
pie	Food (ingredients)
ness	Valid words
sneaker	Objects and things
conner	More names
clinch	Valid words
train	Transportation?
misconduct	Types of people
plastic	Objects and things
proud	Valid words
volkswagen	More names
spade	Objects and things
couch	Transportation?
mikey	First names & prop nouns
cabinet	Valid words
faux	Valid words
flop	Valid words
hyde	More names
era	Valid words
ruthless	Valid words
regular	Valid words
self	Valid words
banker	Valid words
mod	Music words
jasper	Objects and things
crawl	Mostly Verbs
simon	First names & prop nouns
merci	European languages
furrow	Mostly Verbs
shit	Valid words
greatest	Valid words
warm	Objects and things
bump	Mostly Verbs
frozen	Valid words
western	Transportation?
heart	Sciency words
sheffield	First names & prop nouns
sake	Valid words
stricken	Transportation?
tun	European languages
uncommon	Valid words
sermon	Types of people
kira	More names
spokesman	Types of people
borough	Transportation?
bradford	First names & prop nouns
pup	Animals
esteem	Valid words
blend	Valid words
ardent	Types of people
pomeranian	Animals
raft	Valid words
frog	Animals
posit	Mostly Verbs
mammalian	Sciency words
insulin	Sciency words
eight	Valid words
molecular	Sciency words
braid	Objects and things
je	European languages
section	Valid words
flour	Food (ingredients)
dye	Objects and things
modest	Valid words
imp	Types of people
cure	Mostly Verbs
climb	Valid words
film	Valid words
string	Valid words
lina	More names
complement	Mostly Verbs
guo	Chinese/asian languages
flashback	Valid words
nagar	More names
cavendish	More names
overwhelm	Mostly Verbs
laden	Valid words
qaeda	More names
mainstream	Valid words
enchant	Mostly Verbs
impair	Mostly Verbs
ether	Valid words
sheikh	Types of people
gender	Types of people
wagon	Transportation?
tibetan	More names
ono	European languages
data	Valid words
outer	Objects and things
porto	More names
apparel	Objects and things
donkey	Animals
colin	First names & prop nouns
wilson	First names & prop nouns
superman	Types of people
flux	Valid words
mach	European languages
bandwidth	Objects and things
thump	Valid words
sweden	First names & prop nouns
armament	Transportation?
proceed	Mostly Verbs
burnt	Objects and things
ell	European languages
mushroom	Food (ingredients)
haunt	Mostly Verbs
capitalist	Types of people
rift	Valid words
endless	Valid words
han	European languages
leukemia	Sciency words
roi	European languages
devoid	Valid words
protect	Mostly Verbs
fowler	First names & prop nouns
leung	Chinese/asian languages
cleaner	Objects and things
around	Valid words
gal	Types of people
cowboy	Animals
gail	More names
robert	First names & prop nouns
tournament	Valid words
troll	Transportation?
heap	Valid words
vale	European languages
patriarch	Types of people
ambassador	Types of people
eu	First names & prop nouns
dorm	Valid words
emblem	Objects and things
unspoken	Valid words
trick	Valid words
alloy	Objects and things
nut	Food (ingredients)
wool	Objects and things
citadel	Transportation?
aloud	Valid words
fiance	Types of people
rai	Chinese/asian languages
midi	Objects and things
rude	Valid words
abroad	Valid words
screenplay	Valid words
tick	Mostly Verbs
control	Valid words
evi	More names
tie	Valid words
louisiana	First names & prop nouns
chain	Transportation?
inventor	Types of people
almond	Food (ingredients)
distinguish	Mostly Verbs
cutter	More names
pitchfork	Objects and things
chief	Types of people
coup	Types of people
tame	Valid words
best	Valid words
distrust	Valid words
golden	Objects and things
craig	First names & prop nouns
lurk	Mostly Verbs
sander	More names
criterion	Valid words
roller	Objects and things
rent	Valid words
row	Valid words
overseen	Mostly Verbs
shah	Types of people
layer	Objects and things
pound	Transportation?
dana	First names & prop nouns
share	Valid words
effect	Mostly Verbs
rubbish	Objects and things
prompt	Mostly Verbs
mutant	Types of people
ross	First names & prop nouns
elliot	First names & prop nouns
consort	Types of people
render	Valid words
zion	More names
comment	Valid words
uniform	Objects and things
bunker	Transportation?
dress	Objects and things
schwartz	First names & prop nouns
pathogen	Sciency words
overturn	Mostly Verbs
banjo	Music words
heir	Types of people
lamar	More names
dustin	First names & prop nouns
theo	European languages
weaker	Valid words
hole	Transportation?
outward	Valid words
busch	First names & prop nouns
shu	Chinese/asian languages
scatter	Mostly Verbs
congo	More names
burst	Mostly Verbs
sew	Objects and things
bail	Types of people
good	Valid words
winner	Valid words
podium	Valid words
struck	Mostly Verbs
knit	Objects and things
boulevard	Transportation?
connector	Objects and things
phase	Valid words
nah	Valid words
rink	Valid words
tsar	Types of people
avail	Valid words
complaint	Valid words
gamer	Types of people
dracula	More names
ram	Mostly Verbs
crept	Mostly Verbs
manuel	More names
margarita	Food (ingredients)
catcher	Valid words
priest	Types of people
dell	First names & prop nouns
mankind	Types of people
realm	Valid words
fishermen	Animals
kobe	First names & prop nouns
anarchist	Types of people
kapoor	More names
horseback	Animals
wide	Valid words
compel	Mostly Verbs
murdoch	More names
citizen	Types of people
vertigo	Sciency words
ohio	First names & prop nouns
percent	Valid words
dirt	Objects and things
loch	Transportation?
glare	Valid words
sync	Valid words
xavier	More names
perish	Mostly Verbs
rare	Valid words
somehow	Valid words
brother	Types of people
print	Objects and things
portrait	Objects and things
kara	More names
crank	Mostly Verbs
would	Valid words
critic	Types of people
dissent	Valid words
domino	Valid words
irwin	More names
sarah	First names & prop nouns
viaduct	Transportation?
hammer	Objects and things
ti	European languages
suggest	Mostly Verbs
casual	Objects and things
bunch	Valid words
scenic	Transportation?
sci	Valid words
erik	First names & prop nouns
tran	European languages
clare	More names
carp	Animals
that	Valid words
scholarship	Valid words
chao	Chinese/asian languages
ensign	Transportation?
claw	Mostly Verbs
subject	Valid words
you	Valid words
hubbard	More names
pile	Valid words
psi	Sciency words
rebirth	Valid words
hardwood	Objects and things
si	Chinese/asian languages
megan	First names & prop nouns
legion	Mostly Verbs
supplier	Valid words
haa	European languages
lau	More names
pena	European languages
clara	More names
josh	First names & prop nouns
omar	More names
same	Valid words
stood	Mostly Verbs
amor	European languages
beirut	More names
childbirth	Types of people
stellar	Valid words
rayon	Objects and things
yukon	More names
mollusk	Animals
agra	More names
billboard	Valid words
ultraviolet	Objects and things
hulk	Transportation?
abolish	Mostly Verbs
fungal	Sciency words
perfect	Valid words
enough	Valid words
limp	Valid words
stew	Food (ingredients)
boredom	Valid words
physician	Sciency words
refit	Mostly Verbs
belgian	More names
lap	Valid words
sensor	Objects and things
viper	Animals
sic	European languages
ea	European languages
austria	More names
alert	Valid words
retro	Music words
spencer	First names & prop nouns
nickel	Objects and things
uphold	Mostly Verbs
vase	Objects and things
crossbow	Objects and things
fullback	Valid words
skim	Mostly Verbs
cisco	Transportation?
pact	Valid words
kid	Valid words
yield	Valid words
rep	Types of people
civilian	Transportation?
quantum	Sciency words
tumor	Sciency words
berth	Valid words
rang	Mostly Verbs
demolish	Mostly Verbs
dilemma	Valid words
latch	Mostly Verbs
rosa	European languages
nba	First names & prop nouns
consortium	Valid words
ab	European languages
zinc	Objects and things
bologna	Food (ingredients)
marcel	More names
shill	Types of people
panel	Valid words
lincoln	First names & prop nouns
fruit	Food (ingredients)
took	Mostly Verbs
lakshmi	More names
rap	Types of people
smirk	Valid words
deco	Music words
blunt	Valid words
walnut	Objects and things
architect	Types of people
raven	Animals
size	Valid words
stewart	First names & prop nouns
foreign	Valid words
convex	Objects and things
outright	Valid words
ob	European languages
caus	More names
mattress	Transportation?
blur	Valid words
conductor	Music words
stuck	Mostly Verbs
flat	Valid words
orphan	Types of people
cloth	Objects and things
stamp	Valid words
libya	First names & prop nouns
saxon	More names
throne	Types of people
scent	Objects and things
ja	European languages
flower	Objects and things
learn	Valid words
finest	Valid words
eleventh	Valid words
dig	Transportation?
lower	Valid words
risen	Mostly Verbs
shorter	Valid words
olympian	Valid words
borg	More names
rio	European languages
vox	Objects and things
grove	Objects and things
stockholm	More names
outfit	Valid words
dome	Transportation?
agent	Valid words
deck	Transportation?
forth	Valid words
stitch	Objects and things
meredith	First names & prop nouns
it	Valid words
pistol	Objects and things
marin	More names
palo	European languages
shift	Mostly Verbs
sixteen	Valid words
nearest	Valid words
hog	Animals
ked	European languages
tender	Valid words
logan	More names
gu	Chinese/asian languages
king	Types of people
boast	Mostly Verbs
blink	Objects and things
buff	Types of people
patron	Types of people
abandon	Mostly Verbs
mar	Mostly Verbs
heath	Sciency words
outfield	Valid words
harlem	More names
hostess	Types of people
nair	More names
fuji	More names
propaganda	Valid words
puck	Valid words
canton	First names & prop nouns
benedict	European languages
vascular	Sciency words
bring	Mostly Verbs
lost	Mostly Verbs
common	Valid words
shea	Food (ingredients)
andi	More names
payload	Sciency words
weed	Objects and things
fat	Mostly Verbs
sham	Valid words
due	Valid words
rodriguez	First names & prop nouns
batsman	Valid words
better	Valid words
itself	Valid words
hi	Valid words
bordeaux	European languages
wouldn	Valid words
cuff	Objects and things
midfield	Valid words
refrain	Mostly Verbs
hover	Mostly Verbs
forefront	Valid words
steam	Valid words
airplay	Valid words
jackson	First names & prop nouns
skeleton	Objects and things
groan	Valid words
steal	Types of people
quadrant	Objects and things
livestock	Animals
mma	First names & prop nouns
dun	European languages
ist	European languages
pine	Objects and things
bead	Objects and things
rental	Valid words
motionless	Objects and things
nuclear	Objects and things
item	Valid words
dear	Valid words
psychologist	Sciency words
kali	More names
hoffman	More names
bang	Valid words
steward	Types of people
geneva	More names
withdrew	Mostly Verbs
reflex	Valid words
nest	Transportation?
stolen	Types of people
bath	Objects and things
novelist	Valid words
sharpen	Valid words
fourth	Valid words
act	Mostly Verbs
revert	Mostly Verbs
peek	Mostly Verbs
progress	Valid words
will	Valid words
peach	Food (ingredients)
jae	Chinese/asian languages
sheet	Objects and things
diamond	Objects and things
papal	Types of people
conic	More names
counselor	Types of people
mom	Types of people
gen	Objects and things
herd	Animals
woven	Valid words
synth	Music words
now	Valid words
tea	Food (ingredients)
kinda	Valid words
savoy	European languages
tar	Objects and things
schooner	Transportation?
delight	Valid words
birthday	Valid words
like	Valid words
slang	Valid words
lauren	First names & prop nouns
fiona	More names
soil	Objects and things
brat	Types of people
food	Food (ingredients)
broader	Valid words
pollock	Animals
zee	European languages
wesley	First names & prop nouns
campground	Transportation?
oblivion	Valid words
case	Valid words
salsa	Food (ingredients)
rate	Valid words
napoleon	European languages
static	Valid words
trauma	Valid words
rake	Mostly Verbs
duct	Objects and things
boar	Animals
counsel	Types of people
cleanup	Valid words
paranoia	Valid words
cardboard	Objects and things
nasal	Sciency words
guantanamo	More names
twice	Valid words
sasha	First names & prop nouns
creak	Valid words
bueno	European languages
elder	Types of people
thee	Types of people
ara	European languages
supper	Food (ingredients)
franc	Valid words
fragment	Objects and things
waiter	Types of people
click	Objects and things
two	Valid words
ein	European languages
els	European languages
iain	More names
wrote	Valid words
authoritarian	Types of people
fender	Transportation?
southward	Transportation?
anxious	Valid words
sam	European languages
dual	Valid words
cotton	Objects and things
pois	More names
continent	Valid words
milk	Food (ingredients)
frame	Valid words
fourteen	Valid words
aft	Transportation?
finnish	More names
abrupt	Valid words
survivor	Valid words
react	Mostly Verbs
fort	Transportation?
mei	Chinese/asian languages
revolt	Valid words
smallest	Valid words
malcolm	First names & prop nouns
stomach	Valid words
creation	Valid words
selector	Valid words
blaze	Valid words
anand	More names
butler	Types of people
demeanor	Valid words
hous	European languages
whirl	Valid words
tha	European languages
powerless	Valid words
abigail	More names
antenna	Objects and things
norma	More names
expert	Types of people
narrow	Valid words
economist	Types of people
technician	Types of people
devon	First names & prop nouns
livelihood	Types of people
fiesta	Valid words
epic	Valid words
hottest	Valid words
hancock	More names
finn	More names
whilst	Valid words
evan	First names & prop nouns
ching	Chinese/asian languages
noun	Valid words
recent	Valid words
boycott	Valid words
donald	First names & prop nouns
left	Valid words
clutch	Valid words
sweater	Objects and things
jamaica	More names
poss	European languages
zhu	Chinese/asian languages
hoist	Mostly Verbs
pronoun	Valid words
copenhagen	More names
frequent	Valid words
predecessor	Types of people
aurora	Sciency words
madam	Types of people
armor	Transportation?
magnet	Transportation?
mann	European languages
lil	European languages
qui	European languages
ornament	Objects and things
dominican	More names
goddess	Types of people
safe	Valid words
sandra	First names & prop nouns
toll	Valid words
neo	Valid words
safari	Transportation?
inherit	Mostly Verbs
stroke	Sciency words
swamp	Transportation?
af	European languages
unless	Valid words
entertain	Mostly Verbs
rid	Mostly Verbs
garner	Mostly Verbs
poli	European languages
token	Valid words
della	European languages
rye	Food (ingredients)
glacial	Transportation?
eh	Valid words
math	Valid words
hearth	Objects and things
codex	Valid words
cree	More names
dominion	Types of people
streetcar	Transportation?
review	Mostly Verbs
conceal	Types of people
verbal	Sciency words
blazer	Objects and things
total	Valid words
kirk	More names
gap	Mostly Verbs
delta	Transportation?
ultimatum	Valid words
page	Valid words
noah	First names & prop nouns
thorn	Valid words
dem	European languages
our	Valid words
boom	Valid words
furnish	Mostly Verbs
thirst	Valid words
starr	More names
showdown	Valid words
fellow	Types of people
dane	More names
hussein	More names
brendan	First names & prop nouns
clone	Types of people
as	Valid words
sherman	First names & prop nouns
slung	Mostly Verbs
layout	Objects and things
member	Types of people
net	Valid words
bright	Objects and things
hu	Chinese/asian languages
clyde	More names
wig	Objects and things
none	Valid words
project	Valid words
guardian	Types of people
distort	Types of people
crust	Food (ingredients)
kelvin	Sciency words
gomez	First names & prop nouns
stigma	Valid words
poet	Valid words
chiang	Chinese/asian languages
dose	Sciency words
feng	Chinese/asian languages
span	Valid words
scalp	Objects and things
sul	European languages
shook	Mostly Verbs
card	Valid words
down	Valid words
eli	More names
tend	Valid words
lid	Objects and things
suspect	Types of people
contractor	Types of people
goldberg	More names
shut	Mostly Verbs
recoil	Valid words
monkey	Animals
matthew	First names & prop nouns
music	Music words
afghan	Objects and things
prospect	Valid words
give	Mostly Verbs
skirt	Objects and things
ser	European languages
vista	Objects and things
boi	First names & prop nouns
intercept	Mostly Verbs
email	Valid words
behind	Valid words
maiden	Valid words
weigh	Mostly Verbs
thornton	First names & prop nouns
bate	More names
pablo	First names & prop nouns
breathless	Valid words
revisit	Mostly Verbs
flown	Transportation?
jaguar	Animals
rodeo	Animals
tesla	Sciency words
voter	Valid words
embark	Mostly Verbs
ping	Valid words
mirror	Valid words
sein	European languages
harold	First names & prop nouns
sitcom	Valid words
clamp	Mostly Verbs
friend	Types of people
gross	Valid words
jai	More names
joel	First names & prop nouns
ron	First names & prop nouns
cadet	Transportation?
eco	Objects and things
hindi	More names
drawn	Mostly Verbs
vomit	Mostly Verbs
monograph	Valid words
windshield	Transportation?
burrow	Transportation?
rocket	Transportation?
arnold	First names & prop nouns
khalid	More names
cramer	More names
hero	Valid words
golfer	Valid words
torment	Valid words
klan	First names & prop nouns
haitian	More names
strewn	Mostly Verbs
thrust	Mostly Verbs
muster	Mostly Verbs
monument	Transportation?
torpedo	Mostly Verbs
realism	Valid words
leftist	Types of people
lang	Chinese/asian languages
obtain	Mostly Verbs
stubborn	Valid words
defend	Valid words
intellect	Valid words
hove	Transportation?
shame	Valid words
audio	Objects and things
jon	First names & prop nouns
lionel	More names
insignia	Objects and things
jang	Chinese/asian languages
ari	More names
school	Valid words
fault	Valid words
surfer	Valid words
hamburg	European languages
sexual	Types of people
dodd	More names
ham	Food (ingredients)
relationship	Valid words
ethernet	Objects and things
book	Valid words
ecosystem	Transportation?
array	Valid words
unfold	Mostly Verbs
refresh	Mostly Verbs
wand	Objects and things
shortlist	Valid words
numb	Valid words
vertebra	Objects and things
alfredo	European languages
slightest	Valid words
lens	Objects and things
naturalist	Types of people
cage	Transportation?
cup	Food (ingredients)
punt	Valid words
arrest	Types of people
succeed	Mostly Verbs
panchayat	More names
houston	First names & prop nouns
harm	Valid words
gentlemen	More names
metaphor	Valid words
quarterback	Valid words
sweatshirt	Objects and things
feeder	Transportation?
dentist	Sciency words
luna	European languages
blow	Mostly Verbs
shack	Transportation?
hornet	Sciency words
caribbean	First names & prop nouns
richest	Transportation?
bulb	Objects and things
bore	Mostly Verbs
wingspan	Transportation?
acquit	Types of people
harpsichord	Music words
pia	More names
id	First names & prop nouns
swirl	Valid words
cu	Sciency words
mischief	Valid words
martyr	Types of people
piazza	Transportation?
linden	Objects and things
complexion	Valid words
see	Valid words
eurasian	More names
sober	Valid words
fjord	Transportation?
handgun	Objects and things
nail	Mostly Verbs
platinum	Objects and things
theme	Valid words
nell	European languages
trident	Objects and things
retort	Valid words
metro	Transportation?
cub	Animals
tyrant	Types of people
otter	Animals
ik	European languages
corrupt	Types of people
fund	Valid words
indoor	Transportation?
tobacco	Objects and things
spill	Valid words
weld	Sciency words
between	Valid words
netflix	Objects and things
petra	More names
bei	European languages
heartbreak	Valid words
gene	Sciency words
odor	Objects and things
aryan	More names
offer	Valid words
chateau	Transportation?
sector	Valid words
ry	European languages
quan	Chinese/asian languages
aid	Transportation?
rotten	Valid words
eye	Objects and things
zoe	First names & prop nouns
scrape	Mostly Verbs
strength	Valid words
bacterium	Sciency words
hull	Transportation?
professor	Types of people
gloss	Objects and things
mutual	Valid words
contract	Valid words
zeke	More names
twig	Objects and things
carol	Music words
cosmopolitan	Transportation?
bop	Music words
erect	Mostly Verbs
potter	Types of people
boost	Mostly Verbs
vial	Objects and things
log	Valid words
craze	Valid words
swing	Mostly Verbs
jordan	First names & prop nouns
quasi	Valid words
clear	Valid words
gaul	More names
bain	More names
royal	Types of people
mask	Types of people
toxic	Objects and things
moran	First names & prop nouns
barn	Food (ingredients)
didn	Valid words
gel	Objects and things
edinburgh	More names
jihad	Transportation?
merchant	Valid words
damp	Objects and things
con	More names
laid	Mostly Verbs
craven	Valid words
engulf	Objects and things
busiest	Valid words
leap	Mostly Verbs
bee	Sciency words
citizenship	Types of people
stake	Valid words
strata	Objects and things
abu	More names
iss	European languages
weekend	Valid words
daryl	More names
careless	Valid words
alumni	Valid words
underground	Transportation?
track	Valid words
onboard	Transportation?
cabaret	Music words
quinn	First names & prop nouns
flex	Mostly Verbs
riot	Valid words
newport	More names
lana	More names
renew	Mostly Verbs
sentinel	Types of people
hydra	Types of people
fenton	More names
fewer	Valid words
jacket	Objects and things
wheel	Transportation?
maroon	Objects and things
quest	Valid words
cede	Mostly Verbs
husband	Types of people
seam	Transportation?
armada	Transportation?
samuel	First names & prop nouns
yo	European languages
nevada	First names & prop nouns
design	Objects and things
robb	More names
peter	Mostly Verbs
nobel	More names
emir	Types of people
childish	Valid words
vietnam	First names & prop nouns
weasel	Mostly Verbs
pokemon	Objects and things
interim	Types of people
airlift	Transportation?
bela	More names
crap	Valid words
brewer	Food (ingredients)
tae	Chinese/asian languages
cannon	Transportation?
bold	Valid words
keel	Transportation?
freed	Types of people
stu	European languages
can	Valid words
ruler	Types of people
newman	First names & prop nouns
telecom	Objects and things
bash	Valid words
broadcast	Valid words
businessman	Types of people
toss	Mostly Verbs
wizard	Valid words
charcoal	Objects and things
acid	Objects and things
hope	Valid words
roger	First names & prop nouns
bullet	Objects and things
soho	More names
beck	Transportation?
mu	Chinese/asian languages
goth	Music words
vibrant	Transportation?
slot	Valid words
glitter	Objects and things
fresno	First names & prop nouns
happen	Mostly Verbs
muscular	Mostly Verbs
realist	Types of people
castillo	First names & prop nouns
hydro	Transportation?
suffolk	First names & prop nouns
ame	European languages
highlight	Valid words
avid	Types of people
prima	European languages
hail	Valid words
apartheid	Types of people
senior	Valid words
arc	Valid words
landlord	Valid words
fifth	Valid words
warn	Valid words
deport	Types of people
seven	Valid words
nap	Transportation?
griffin	Types of people
carr	European languages
skill	Valid words
pat	Valid words
soc	First names & prop nouns
bean	Food (ingredients)
bread	Food (ingredients)
purport	Mostly Verbs
sick	Valid words
chemist	Types of people
flung	Mostly Verbs
south	Transportation?
circa	Valid words
javelin	Valid words
elton	More names
wright	First names & prop nouns
user	Objects and things
mani	More names
sooth	Mostly Verbs
flourish	Mostly Verbs
anguish	Valid words
sale	Valid words
landau	Transportation?
match	Valid words
stranger	Types of people
vinegar	Food (ingredients)
predict	Valid words
winston	More names
holocaust	Types of people
pow	Valid words
blast	Valid words
overland	Transportation?
bake	Objects and things
time	Valid words
quay	Transportation?
intel	First names & prop nouns
dubai	First names & prop nouns
mongolian	More names
juliet	More names
tandem	Valid words
pure	Valid words
older	Types of people
detail	Objects and things
coffin	Transportation?
chamberlain	Types of people
hear	Valid words
youngest	Valid words
tit	Valid words
antarctica	More names
ballast	Transportation?
jude	More names
alexandra	More names
liverpool	First names & prop nouns
shortest	Valid words
westbound	Transportation?
heartbeat	Sciency words
chang	Chinese/asian languages
ni	Chinese/asian languages
fasten	Mostly Verbs
favor	Valid words
blake	First names & prop nouns
elbow	Objects and things
bennett	First names & prop nouns
maria	European languages
talk	Valid words
humanitarian	Transportation?
scratch	Mostly Verbs
sport	Valid words
ruben	More names
clinic	Sciency words
horatio	More names
instant	Valid words
unfamiliar	Valid words
mesa	Transportation?
scandinavian	More names
shirley	First names & prop nouns
goodnight	Valid words
eat	Mostly Verbs
state	Valid words
cat	Animals
small	Valid words
write	Valid words
tenth	Valid words
stryker	More names
coral	Transportation?
odyssey	Valid words
parchment	Valid words
serial	Valid words
ulster	More names
ahmad	More names
vector	Sciency words
shatter	Mostly Verbs
flare	Objects and things
poster	Valid words
zur	European languages
curb	Mostly Verbs
greater	Valid words
onslaught	Valid words
prescott	More names
groin	Objects and things
convoy	Transportation?
arid	Transportation?
trace	Mostly Verbs
shamrock	More names
proctor	Types of people
ave	European languages
launcher	Transportation?
reject	Mostly Verbs
womb	Types of people
discard	Mostly Verbs
shipyard	Transportation?
michigan	First names & prop nouns
jew	First names & prop nouns
speech	Valid words
remnant	Objects and things
tens	Valid words
kun	Chinese/asian languages
ted	European languages
greyhound	Animals
autumn	Valid words
faint	Objects and things
smell	Objects and things
tighten	Mostly Verbs
safeguard	Mostly Verbs
light	Objects and things
throb	Valid words
mission	Valid words
lifespan	Valid words
receptionist	Types of people
sawyer	More names
ramirez	More names
minion	Types of people
bedford	More names
wi	European languages
liza	More names
rig	Transportation?
bulletin	Valid words
goos	More names
rossi	First names & prop nouns
capt	European languages
conrad	More names
gulf	Mostly Verbs
methodist	More names
vocal	Types of people
moi	European languages
east	Transportation?
bacon	Food (ingredients)
line	Valid words
stuf	More names
gulp	Mostly Verbs
bulldog	Animals
cancel	Mostly Verbs
tre	European languages
champion	Valid words
human	Types of people
solemn	Valid words
steamer	Transportation?
romano	European languages
fest	Valid words
prem	First names & prop nouns
tuesday	First names & prop nouns
umm	Valid words
rasp	Mostly Verbs
armstrong	First names & prop nouns
make	Valid words
grown	Mostly Verbs
tau	Sciency words
learner	Valid words
worsen	Mostly Verbs
rene	More names
phenomenon	Valid words
heat	Objects and things
those	Valid words
summit	Valid words
credit	Valid words
martha	First names & prop nouns
avoid	Mostly Verbs
burt	More names
cobra	Animals
rob	Types of people
resign	Mostly Verbs
fring	Objects and things
mean	Valid words
nee	European languages
slender	Mostly Verbs
rodney	First names & prop nouns
complain	Valid words
irish	More names
ar	European languages
bach	Transportation?
help	Mostly Verbs
hamilton	First names & prop nouns
until	Valid words
mentor	Valid words
foul	Valid words
verdict	Valid words
macintosh	First names & prop nouns
hbo	First names & prop nouns
pinch	Mostly Verbs
lila	More names
goo	Objects and things
nephew	Types of people
primera	European languages
corey	First names & prop nouns
cairn	Transportation?
solar	Objects and things
relay	Valid words
barrack	Transportation?
tab	Objects and things
helix	Sciency words
transfer	Mostly Verbs
lal	More names
difficult	Valid words
bleak	Valid words
low	Valid words
visual	Sciency words
assault	Valid words
aye	More names
tina	First names & prop nouns
chairperson	Types of people
confirm	Valid words
nazi	First names & prop nouns
occasion	Valid words
olsen	More names
deer	Animals
cadillac	More names
sneer	Valid words
olivia	First names & prop nouns
superhuman	Types of people
restrain	Mostly Verbs
seth	More names
browser	Objects and things
tonight	Valid words
tavern	Transportation?
gina	More names
babylon	More names
solo	Music words
matrix	Sciency words
pretend	Mostly Verbs
clint	First names & prop nouns
nile	More names
maid	Types of people
spearhead	Mostly Verbs
assert	Valid words
reaper	Types of people
note	Valid words
chip	Sciency words
thief	Types of people
acquaint	Mostly Verbs
reactor	Objects and things
landmark	Valid words
pork	Food (ingredients)
downstream	Transportation?
spur	Mostly Verbs
worker	Types of people
radiant	Objects and things
tough	Valid words
bronco	Animals
wield	Mostly Verbs
helen	First names & prop nouns
mascara	Objects and things
band	Music words
cushion	Valid words
hunger	Valid words
request	Valid words
hideout	Transportation?
pud	More names
hash	Mostly Verbs
visa	Types of people
jug	Food (ingredients)
went	Mostly Verbs
scream	Valid words
scandal	Types of people
jane	First names & prop nouns
runner	Valid words
asteroid	Sciency words
overs	Valid words
pagoda	Transportation?
blind	Valid words
redhead	Types of people
sped	Mostly Verbs
ami	More names
abbess	Types of people
lui	European languages
obey	Mostly Verbs
sullivan	First names & prop nouns
clement	Transportation?
photo	Objects and things
buddhism	More names
asha	More names
zulu	More names
ryder	More names
earth	Types of people
aluminum	Objects and things
buffet	Food (ingredients)
haze	Objects and things
flutter	Valid words
columnist	Types of people
brandt	More names
burger	Food (ingredients)
dona	European languages
tai	Chinese/asian languages
organ	Objects and things
pair	Valid words
bind	Mostly Verbs
oldest	Valid words
divers	Valid words
guild	Valid words
shelf	Valid words
gran	Types of people
oxygen	Objects and things
hing	Chinese/asian languages
foe	Valid words
tooth	Objects and things
harass	Types of people
fielder	Valid words
blair	First names & prop nouns
clue	Valid words
weiss	European languages
goin	Valid words
ashley	First names & prop nouns
storey	Transportation?
suarez	First names & prop nouns
reed	Objects and things
pod	Transportation?
armenian	More names
es	European languages
tour	Valid words
bog	Transportation?
upright	Objects and things
option	Valid words
rich	Transportation?
marvel	Mostly Verbs
gao	Chinese/asian languages
glaze	Objects and things
choir	Music words
lure	Mostly Verbs
be	Valid words
taunt	Mostly Verbs
shave	Mostly Verbs
cricket	Valid words
detach	Mostly Verbs
seventeenth	Valid words
dime	Valid words
miss	Mostly Verbs
spa	Objects and things
pertain	Mostly Verbs
gold	Objects and things
sleek	Objects and things
implant	Objects and things
khan	More names
superstar	Valid words
luther	More names
sienna	Objects and things
francais	European languages
price	Valid words
haggard	Valid words
moe	European languages
combust	Objects and things
musician	Music words
fever	Valid words
bran	Food (ingredients)
drip	Mostly Verbs
thrown	Mostly Verbs
pleasant	Valid words
halloween	More names
clair	More names
prove	Valid words
receipt	Valid words
blame	Valid words
tidal	Transportation?
imprison	Types of people
carousel	Transportation?
delay	Mostly Verbs
jonah	More names
cedar	Objects and things
them	Valid words
theft	Types of people
stab	Mostly Verbs
photon	Sciency words
archbishop	Types of people
collin	More names
arm	Objects and things
hunter	Animals
gust	Valid words
midday	Valid words
viva	Valid words
til	Valid words
cohen	First names & prop nouns
parallel	Valid words
piston	Sciency words
manifold	Valid words
terrorist	Transportation?
yin	Chinese/asian languages
er	Valid words
feral	Transportation?
setup	Valid words
cop	Types of people
laud	Valid words
diagram	Valid words
nylon	Objects and things
shimmer	Objects and things
sharon	First names & prop nouns
harvest	Food (ingredients)
foster	Types of people
babu	More names
gi	More names
wilder	Transportation?
chime	Valid words
rollin	Valid words
deeper	Transportation?
murray	First names & prop nouns
weaver	Types of people
globe	Valid words
coconut	Food (ingredients)
danger	Valid words
pigment	Objects and things
gaze	Valid words
darken	Objects and things
statesman	Types of people
luc	European languages
mausoleum	Transportation?
leaf	Objects and things
thereof	European languages
naval	Transportation?
dungeon	Transportation?
pam	First names & prop nouns
orb	Objects and things
brilliant	Valid words
weekday	Valid words
mike	Objects and things
jet	Transportation?
fling	Valid words
thai	First names & prop nouns
nato	First names & prop nouns
deploy	Mostly Verbs
jersey	Objects and things
mort	European languages
tragic	Valid words
jim	First names & prop nouns
tu	European languages
abyss	Valid words
mice	Sciency words
vapor	Objects and things
expo	Valid words
dai	European languages
wat	European languages
contempt	Valid words
latino	First names & prop nouns
diver	Valid words
herald	Mostly Verbs
roman	Types of people
virus	Sciency words
steamship	Transportation?
yearbook	Valid words
poison	Objects and things
middleweight	Valid words
mail	Transportation?
le	European languages
tod	European languages
mess	Valid words
outreach	Types of people
restrict	Mostly Verbs
fox	Animals
violinist	Music words
nineteenth	Valid words
robin	Animals
boe	Transportation?
northwest	Transportation?
alter	Mostly Verbs
facial	Objects and things
strike	Mostly Verbs
influenza	Sciency words
bother	Valid words
drunken	Food (ingredients)
chen	Chinese/asian languages
eyelash	Objects and things
cox	Transportation?
whereupon	Valid words
plumb	Mostly Verbs
pi	European languages
brain	Sciency words
patel	More names
arab	First names & prop nouns
sarcasm	Valid words
host	Valid words
lisa	First names & prop nouns
sect	Types of people
america	First names & prop nouns
slater	First names & prop nouns
closest	Valid words
saloon	Transportation?
feb	First names & prop nouns
quarter	Valid words
prakash	More names
telegram	Transportation?
conduct	Mostly Verbs
wreck	Valid words
kashmir	First names & prop nouns
dunn	First names & prop nouns
angelica	Objects and things
birth	Types of people
courtroom	Valid words
extra	Valid words
mage	Types of people
zen	Valid words
carlo	First names & prop nouns
speed	Valid words
fin	Objects and things
ethiopian	More names
youth	Types of people
bin	Transportation?
aquarium	Animals
howl	Valid words
outset	Valid words
lai	Chinese/asian languages
drill	Transportation?
slick	Valid words
peru	More names
miranda	First names & prop nouns
emi	First names & prop nouns
robe	Objects and things
harsh	Valid words
cam	Objects and things
mist	Objects and things
hangar	Transportation?
yuan	Chinese/asian languages
im	European languages
backpack	Objects and things
parisian	More names
terri	More names
meyer	More names
lumber	Objects and things
whitish	Objects and things
unbeaten	Valid words
writer	Types of people
businessmen	Types of people
interview	Valid words
bargain	Valid words
belmont	More names
continuum	Valid words
ani	Chinese/asian languages
expel	Types of people
plea	Valid words
yahoo	First names & prop nouns
throw	Mostly Verbs
valiant	Valid words
beyond	Valid words
thing	Valid words
replay	Valid words
inland	Transportation?
ho	Chinese/asian languages
greyish	Objects and things
gag	Mostly Verbs
meat	Food (ingredients)
flora	Transportation?
boo	Valid words
parker	First names & prop nouns
daniel	First names & prop nouns
scene	Valid words
ny	First names & prop nouns
waltz	Music words
bland	Valid words
walker	Objects and things
spoon	Food (ingredients)
traffic	Transportation?
freeman	Types of people
yell	Valid words
ki	Chinese/asian languages
launch	Valid words
sprinter	Valid words
newscast	Valid words
sheriff	Types of people
proton	Sciency words
hyun	Chinese/asian languages
ann	European languages
vanilla	Food (ingredients)
prank	Valid words
heck	Valid words
board	Valid words
hate	Valid words
seismic	Valid words
radial	Sciency words
logo	Objects and things
mansion	Transportation?
obsess	Valid words
para	European languages
gemma	More names
swap	Mostly Verbs
final	Valid words
newfound	Valid words
rancho	Transportation?
jerk	Valid words
wetland	Transportation?
extinguish	Valid words
mold	Objects and things
stefan	More names
junior	Valid words
knife	Objects and things
russian	First names & prop nouns
bitter	Valid words
infant	Types of people
afar	Mostly Verbs
liu	Chinese/asian languages
ottoman	Transportation?
crane	Transportation?
et	European languages
chandler	First names & prop nouns
limit	Mostly Verbs
missouri	First names & prop nouns
halfway	Valid words
vip	First names & prop nouns
tri	Valid words
home	Valid words
by	Valid words
wise	Valid words
cameo	Types of people
fa	European languages
neon	Objects and things
hector	Mostly Verbs
preseason	Valid words
firework	Objects and things
vacuum	Mostly Verbs
southbound	Transportation?
skipper	Valid words
frederick	More names
edit	Objects and things
fernandez	More names
sonia	More names
disdain	Valid words
mona	More names
digger	Objects and things
crow	Animals
cheer	Valid words
karma	Valid words
tata	More names
tang	Food (ingredients)
hardship	Valid words
tune	Valid words
walk	Mostly Verbs
gwen	First names & prop nouns
gram	Objects and things
len	European languages
interrupt	Mostly Verbs
adam	First names & prop nouns
swell	Mostly Verbs
hale	Valid words
cobb	European languages
calendar	Valid words
vicki	First names & prop nouns
lest	Valid words
peculiar	Valid words
standard	Valid words
foam	Objects and things
russo	More names
plume	Sciency words
teach	Valid words
northeast	Transportation?
cannot	Valid words
flame	Objects and things
risk	Valid words
canal	Transportation?
chin	Objects and things
beacon	Objects and things
disturb	Mostly Verbs
withdraw	Mostly Verbs
paul	First names & prop nouns
barker	More names
skater	Valid words
rest	Valid words
lulu	More names
dieter	Sciency words
booker	Types of people
governor	Valid words
mile	Valid words
twilight	Objects and things
benefactor	Types of people
bomb	Valid words
extinct	Objects and things
spaceship	Sciency words
amp	Objects and things
hatch	Transportation?
crude	Objects and things
implement	Mostly Verbs
ella	Sciency words
oak	Objects and things
import	Valid words
nelson	First names & prop nouns
sleep	Transportation?
pig	Animals
valid	Valid words
shutter	Mostly Verbs
georgetown	More names
loud	Valid words
soul	Music words
default	Mostly Verbs
breeder	Animals
qing	Chinese/asian languages
syrup	Food (ingredients)
pigeon	Animals
stamped	Valid words
man	Types of people
croft	Transportation?
commend	Valid words
goblin	Types of people
sieg	More names
boy	Types of people
drama	Valid words
through	Valid words
ra	European languages
fact	Valid words
overhead	Valid words
hall	Transportation?
stink	Valid words
grip	Valid words
enact	Mostly Verbs
unbroken	Valid words
pianist	Music words
usb	First names & prop nouns
dwarf	Objects and things
cock	Animals
scrub	Objects and things
costa	European languages
champaign	Food (ingredients)
raw	Mostly Verbs
har	European languages
ju	Chinese/asian languages
gut	Valid words
department	Valid words
priori	Sciency words
squint	Valid words
web	Valid words
hostel	Transportation?
swan	Animals
nara	More names
sap	Objects and things
grader	Valid words
attempt	Valid words
blackout	Valid words
emerald	Objects and things
tiger	Animals
sack	Mostly Verbs
miller	More names
major	Valid words
bill	Valid words
neuron	Sciency words
ba	European languages
bias	Valid words
mormon	Types of people
yan	Chinese/asian languages
motorsport	Valid words
chicago	First names & prop nouns
cum	Valid words
mercer	More names
abe	More names
is	Valid words
enter	Mostly Verbs
develop	Mostly Verbs
shock	Valid words
dirk	First names & prop nouns
glenn	First names & prop nouns
togo	More names
sedan	Transportation?
mute	Valid words
multi	Valid words
ike	European languages
lava	Sciency words
nobleman	Types of people
slogan	Valid words
waterfront	Transportation?
rodent	Animals
mig	European languages
csi	First names & prop nouns
name	Valid words
worth	Valid words
nix	Mostly Verbs
duncan	First names & prop nouns
peasant	Types of people
avant	Music words
hymn	Music words
cappella	Music words
ned	European languages
intent	Valid words
norway	More names
crest	Valid words
tito	First names & prop nouns
enamel	Objects and things
hem	Objects and things
fritz	Valid words
stench	Objects and things
mark	Valid words
headlight	Transportation?
told	Valid words
korean	First names & prop nouns
glacier	Transportation?
whoa	Valid words
outing	Valid words
swept	Valid words
sociologist	Types of people
christian	Types of people
gain	Mostly Verbs
cheung	Chinese/asian languages
merit	Sciency words
bam	Valid words
potassium	Sciency words
pawn	Valid words
herbert	More names
crowd	Valid words
oz	Objects and things
atop	Valid words
ga	European languages
defect	Valid words
nassau	More names
dim	Objects and things
cher	European languages
morrison	First names & prop nouns
empower	Mostly Verbs
sanskrit	More names
bankrupt	Valid words
repeal	Mostly Verbs
byte	Objects and things
launder	Types of people
baba	More names
contact	Valid words
ile	European languages
aerial	Transportation?
warren	Transportation?
ferrari	More names
rome	More names
sergeant	Transportation?
bacteria	Sciency words
archaeologist	Types of people
punish	Types of people
chronic	Sciency words
plaster	Objects and things
di	European languages
inca	More names
clad	Objects and things
triumph	Valid words
dispatch	Valid words
chapter	Valid words
liken	Valid words
new	Valid words
ek	Chinese/asian languages
shade	Objects and things
spice	Food (ingredients)
sudden	Valid words
eldest	Types of people
hopeless	Valid words
gradient	Sciency words
theorem	Types of people
hagen	More names
uv	European languages
therefor	Valid words
ideal	Valid words
cello	Music words
tropic	Transportation?
sufi	More names
tong	Chinese/asian languages
aspen	Objects and things
parkway	Transportation?
solvent	Objects and things
craftsman	Types of people
fiat	Valid words
region	Transportation?
unfit	Valid words
off	Valid words
gia	European languages
dalton	More names
park	Transportation?
vow	Valid words
sung	Music words
chan	Chinese/asian languages
choral	Music words
wider	Valid words
govern	Valid words
statehood	Types of people
each	Valid words
mandi	More names
her	Types of people
fulton	More names
alf	More names
campo	European languages
coma	Sciency words
zoo	Animals
tia	More names
fingernail	Objects and things
confer	Mostly Verbs
mother	Types of people
badminton	Valid words
librarian	Types of people
plan	Valid words
poe	European languages
petersburg	More names
hasn	Valid words
clayton	First names & prop nouns
regan	More names
worn	Objects and things
bing	Chinese/asian languages
shoe	Objects and things
soda	Food (ingredients)
adrian	First names & prop nouns
preview	Valid words
violin	Music words
speedway	Valid words
resort	Transportation?
artwork	Objects and things
beach	Transportation?
madonna	First names & prop nouns
regina	More names
eaten	Mostly Verbs
silva	First names & prop nouns
grade	Objects and things
aria	Music words
convey	Mostly Verbs
minor	Valid words
growl	Valid words
gay	Types of people
nascar	First names & prop nouns
adapt	Mostly Verbs
ident	European languages
clip	Valid words
bolt	Mostly Verbs
auditorium	Transportation?
midwest	Transportation?
nun	Types of people
loan	Valid words
graph	Valid words
polk	More names
protocol	Valid words
heron	Animals
cheney	First names & prop nouns
persist	Mostly Verbs
follow	Mostly Verbs
guinea	More names
usa	First names & prop nouns
statement	Valid words
care	Sciency words
widen	Mostly Verbs
fray	Valid words
atrium	Transportation?
letter	Valid words
ricardo	More names
overhaul	Mostly Verbs
counter	Mostly Verbs
flair	Valid words
cigar	Objects and things
anthropologist	Types of people
rabbit	Animals
riley	First names & prop nouns
breadth	Valid words
for	Valid words
cooper	More names
lever	Objects and things
columbia	First names & prop nouns
akin	Valid words
opium	Food (ingredients)
knowl	More names
similar	Valid words
absent	Valid words
starboard	Transportation?
victim	Types of people
nitrogen	Sciency words
makeshift	Valid words
bruno	First names & prop nouns
amazon	First names & prop nouns
shrine	Transportation?
tap	Mostly Verbs
eyelid	Objects and things
theresa	More names
lick	Mostly Verbs
malaysian	More names
tee	Transportation?
nation	Valid words
lent	Valid words
calcium	Sciency words
cab	Transportation?
seek	Valid words
stein	Food (ingredients)
humid	Objects and things
ibn	More names
deposit	Valid words
motion	Valid words
carey	More names
redskin	More names
astronaut	Sciency words
straight	Valid words
resurrect	Mostly Verbs
catalog	Valid words
river	Transportation?
wrought	Valid words
jerusalem	More names
screw	Mostly Verbs
commando	Transportation?
wisdom	Valid words
beg	Valid words
greta	Types of people
number	Valid words
weston	More names
crave	Mostly Verbs
visit	Valid words
wed	Types of people
forehead	Objects and things
tango	Music words
steer	Mostly Verbs
nomad	Transportation?
pickup	Transportation?
blackish	Objects and things
amir	Types of people
wiley	More names
tim	First names & prop nouns
bourbon	Food (ingredients)
barrier	Valid words
utopia	Valid words
doorstep	Transportation?
dozen	Valid words
meant	Valid words
cook	Objects and things
cann	More names
attract	Mostly Verbs
merger	Valid words
wan	European languages
dover	More names
tractor	Transportation?
fell	Mostly Verbs
treason	Types of people
meek	Valid words
neutron	Objects and things
ahead	Valid words
grandma	Types of people
iceland	More names
stairway	Transportation?
lover	Types of people
fernando	First names & prop nouns
begin	Valid words
millennium	Valid words
bob	Objects and things
killer	Types of people
healer	Types of people
edward	First names & prop nouns
rani	More names
raider	Types of people
clearer	Valid words
beef	Food (ingredients)
mecca	Transportation?
drew	Mostly Verbs
denmark	More names
freud	More names
prolong	Mostly Verbs
group	Valid words
hello	Valid words
phantom	Valid words
printer	Objects and things
tonic	Mostly Verbs
sofia	More names
fey	Types of people
ul	More names
paso	Music words
cleveland	First names & prop nouns
gunshot	Objects and things
rot	Objects and things
doesn	Valid words
maxim	Valid words
chess	Valid words
trent	First names & prop nouns
san	Chinese/asian languages
pixel	Objects and things
falter	Mostly Verbs
investor	Valid words
ill	Valid words
breakfast	Food (ingredients)
yue	Chinese/asian languages
burn	Objects and things
echo	Valid words
swat	Mostly Verbs
refuge	Transportation?
grim	Valid words
desktop	Objects and things
nur	European languages
deficit	Valid words
allah	More names
proof	Valid words
renown	Valid words
hammond	More names
marilyn	More names
textual	Sciency words
cullen	More names
sting	Valid words
jewish	First names & prop nouns
joshua	First names & prop nouns
vill	European languages
eas	European languages
smile	Valid words
pittsburgh	First names & prop nouns
rope	Objects and things
bank	Valid words
flash	Objects and things
wee	More names
mob	Types of people
hermit	Transportation?
familiar	Valid words
oregon	First names & prop nouns
toxin	Objects and things
simpson	First names & prop nouns
cinderella	Valid words
phoenix	Valid words
archdeacon	Types of people
myriad	Valid words
sara	First names & prop nouns
vowel	Valid words
hare	Animals
pentagon	First names & prop nouns
vegetarian	Food (ingredients)
wavelength	Sciency words
oust	Types of people
rust	Objects and things
lund	More names
blossom	Mostly Verbs
syn	European languages
mundo	European languages
dean	Types of people
node	Objects and things
awaken	Valid words
relaunch	Valid words
referendum	Valid words
romeo	More names
saudi	First names & prop nouns
lex	European languages
fig	Food (ingredients)
glow	Objects and things
shell	Mostly Verbs
shed	Mostly Verbs
abbot	Types of people
befriend	Types of people
handcuff	Mostly Verbs
gabriel	More names
tracker	Valid words
cluster	Valid words
panda	Animals
colleen	More names
faster	Valid words
undertaken	Mostly Verbs
mason	Types of people
club	Valid words
eros	Types of people
tint	Objects and things
half	Valid words
carrier	Transportation?
morgan	First names & prop nouns
distress	Valid words
liquor	Food (ingredients)
fed	Mostly Verbs
station	Transportation?
fork	Mostly Verbs
nave	Transportation?
mao	Chinese/asian languages
magma	Sciency words
dudley	More names
battlefield	Transportation?
susan	First names & prop nouns
miner	Objects and things
paperback	Valid words
stream	Mostly Verbs
desert	Transportation?
bunk	Transportation?
rick	First names & prop nouns
playwright	Valid words
dweller	Transportation?
tailor	Mostly Verbs
snyder	First names & prop nouns
childhood	Types of people
eager	Valid words
howe	More names
gaelic	More names
strengthen	Mostly Verbs
defeat	Valid words
turkey	Food (ingredients)
queen	Types of people
chester	First names & prop nouns
dragon	Types of people
peyton	First names & prop nouns
pandit	More names
serum	Sciency words
xbox	Objects and things
angela	First names & prop nouns
trader	Valid words
reef	Transportation?
trio	Valid words
pennant	Valid words
sanjay	More names
scheme	Valid words
syrian	More names
guitar	Music words
yeast	Sciency words
spinal	Objects and things
david	First names & prop nouns
da	European languages
wo	First names & prop nouns
relief	Transportation?
vincent	First names & prop nouns
iraqi	First names & prop nouns
pull	Mostly Verbs
concert	Valid words
doll	Transportation?
yemen	More names
the	Valid words
neck	Objects and things
bribe	Types of people
under	Valid words
gardner	More names
household	Types of people
friday	First names & prop nouns
biomass	Objects and things
slice	Food (ingredients)
cord	Objects and things
muller	More names
electromagnet	Objects and things
villain	Types of people
solomon	More names
murmur	Valid words
heartland	Transportation?
metadata	Sciency words
eastbound	Transportation?
opt	Valid words
stella	More names
robber	Types of people
yank	Mostly Verbs
distraught	Valid words
va	European languages
boiler	Objects and things
ran	Mostly Verbs
wood	Objects and things
consider	Mostly Verbs
lac	More names
dip	Mostly Verbs
dora	More names
beaux	European languages
gorilla	Animals
lago	More names
tack	Valid words
decent	Valid words
silent	Valid words
logic	Sciency words
lamb	Food (ingredients)
pilgrim	Transportation?
presbyterian	More names
suit	Valid words
sight	Valid words
og	European languages
reacher	Mostly Verbs
dial	Valid words
repress	Types of people
point	Valid words
transform	Mostly Verbs
doe	Animals
ida	More names
remain	Mostly Verbs
plot	Valid words
grandpa	Types of people
transplant	Sciency words
vassal	Types of people
women	Types of people
junk	Objects and things
catholic	Types of people
jail	Types of people
leah	First names & prop nouns
salad	Food (ingredients)
felt	Valid words
chunk	Valid words
plain	Valid words
digit	Valid words
pedal	Transportation?
damn	Valid words
professorship	Types of people
saul	More names
cain	First names & prop nouns
dish	Food (ingredients)
tire	Transportation?
research	Valid words
staunch	Types of people
pit	Valid words
cubic	Sciency words
afro	Objects and things
driver	Transportation?
spotlight	Valid words
have	Valid words
bio	Valid words
real	Valid words
trail	Transportation?
person	Types of people
highway	Transportation?
sunset	Objects and things
sodium	Sciency words
moscow	More names
primal	Types of people
industrialist	Types of people
muir	More names
pol	Types of people
neither	Valid words
implicit	Valid words
model	Valid words
app	Objects and things
government	Valid words
geek	Types of people
fingertip	Objects and things
tomato	Food (ingredients)
cancer	Sciency words
ana	European languages
calm	Valid words
album	Music words
siren	Valid words
output	Mostly Verbs
curious	Valid words
en	European languages
cleans	Objects and things
shin	Objects and things
militia	Types of people
fortress	Transportation?
brit	European languages
onto	Valid words
yu	Chinese/asian languages
invalid	Valid words
pilot	Transportation?
wast	European languages
consist	Mostly Verbs
gang	Types of people
inter	Valid words
porcelain	Objects and things
pardon	Types of people
philip	First names & prop nouns
friction	Valid words
concept	Valid words
coco	Food (ingredients)
um	Valid words
isla	European languages
sat	Mostly Verbs
shrub	Objects and things
violet	Objects and things
stil	European languages
brass	Objects and things
surround	Mostly Verbs
ticket	Valid words
clasp	Objects and things
detector	Objects and things
synonym	Valid words
sera	Sciency words
perform	Mostly Verbs
tao	Chinese/asian languages
grave	Transportation?
tattoo	Objects and things
ufo	More names
buena	European languages
trek	Valid words
clergyman	Types of people
elk	Animals
assist	Mostly Verbs
tex	European languages
thunder	Valid words
asylum	Types of people
huff	Objects and things
script	Valid words
fi	European languages
vitro	Sciency words
gun	Objects and things
iron	Transportation?
abba	More names
abort	Mostly Verbs
blue	Objects and things
tide	Valid words
flavor	Food (ingredients)
prose	Valid words
inlet	Transportation?
theater	Valid words
background	Valid words
open	Valid words
outbreak	Sciency words
kristin	First names & prop nouns
hart	European languages
object	Objects and things
veronica	More names
sergio	First names & prop nouns
clap	Valid words
melinda	More names
all	Valid words
bug	Sciency words
warmth	Valid words
razor	Objects and things
grime	Objects and things
mic	Objects and things
turn	Mostly Verbs
ci	European languages
mor	European languages
madeira	European languages
birch	Objects and things
cheaper	Valid words
green	Objects and things
mislead	Types of people
stage	Valid words
python	Animals
area	Transportation?
dead	Valid words
mistress	Types of people
bo	European languages
market	Valid words
patrol	Types of people
brooklyn	First names & prop nouns
bathroom	Transportation?
paulo	More names
wife	Types of people
com	First names & prop nouns
mala	More names
post	Valid words
ashok	More names
basket	Valid words
huge	Valid words
servicemen	Transportation?
cloud	Objects and things
downtown	Transportation?
timer	Objects and things
england	First names & prop nouns
known	Valid words
carson	First names & prop nouns
cleric	Types of people
ru	European languages
tube	Objects and things
glove	Objects and things
broadband	Objects and things
search	Valid words
matt	Objects and things
collector	Objects and things
holland	First names & prop nouns
bite	Mostly Verbs
hudson	First names & prop nouns
encrypt	Objects and things
nothin	Valid words
jean	Objects and things
pri	European languages
randolph	More names
grover	More names
tamara	More names
chico	European languages
tian	More names
lifeboat	Transportation?
oakland	First names & prop nouns
explicit	Valid words
heroism	Transportation?
sept	First names & prop nouns
fade	Mostly Verbs
tore	Mostly Verbs
walsh	First names & prop nouns
blackburn	First names & prop nouns
dark	Objects and things
seventh	Valid words
bye	Valid words
inferno	Valid words
forgot	Valid words
karat	Objects and things
magnesium	Objects and things
forecast	Valid words
exhaust	Transportation?
como	European languages
ud	More names
disrepair	Objects and things
batter	Valid words
fran	European languages
flank	Valid words
widespread	Valid words
closet	Transportation?
cantata	Music words
moos	Valid words
drape	Mostly Verbs
pale	Objects and things
rhyme	Valid words
mir	European languages
mai	European languages
wicket	Valid words
usc	First names & prop nouns
humanoid	Types of people
everett	More names
pang	Valid words
virginia	First names & prop nouns
adjust	Mostly Verbs
lou	First names & prop nouns
coach	Valid words
environment	Valid words
reuben	European languages
ox	Animals
erin	First names & prop nouns
memorandum	Valid words
adi	More names
sprang	Mostly Verbs
bless	Types of people
pathway	Valid words
catfish	Animals
bourn	More names
prefix	Valid words
comprehend	Mostly Verbs
quiet	Valid words
sophia	First names & prop nouns
vin	European languages
newest	Valid words
mario	Objects and things
ben	More names
isn	Valid words
fun	Valid words
fellowship	Valid words
woo	Mostly Verbs
archway	Transportation?
tudor	Valid words
shoulder	Objects and things
probe	Types of people
hugh	European languages
cockpit	Transportation?
dolor	European languages
roof	Transportation?
hunch	Valid words
clown	Valid words
ask	Valid words
stump	Mostly Verbs
emit	Objects and things
bavarian	More names
nonetheless	Valid words
fifteenth	Valid words
indiana	First names & prop nouns
seo	More names
lindsay	First names & prop nouns
roe	Animals
inform	Mostly Verbs
seafood	Animals
zionist	First names & prop nouns
successor	Types of people
vida	European languages
void	Mostly Verbs
diet	Sciency words
stark	Valid words
worm	Sciency words
snake	Animals
loosen	Mostly Verbs
maison	European languages
francisco	More names
basalt	Objects and things
cuckoo	Animals
penal	Valid words
honda	More names
maj	European languages
islamist	First names & prop nouns
bouquet	Objects and things
zip	Objects and things
glisten	Objects and things
gallant	Valid words
heel	Objects and things
mount	Mostly Verbs
outlet	Valid words
ucla	First names & prop nouns
walton	First names & prop nouns
saw	Valid words
beard	Objects and things
firearm	Objects and things
whale	Animals
afford	Valid words
epsilon	Sciency words
breach	Types of people
copyright	Valid words
hunt	Valid words
hockey	Valid words
kata	Valid words
into	Valid words
restraint	Valid words
seamen	Transportation?
dani	First names & prop nouns
mega	Valid words
trap	Transportation?
heard	Valid words
ordain	Types of people
confront	Mostly Verbs
forearm	Objects and things
pastor	Types of people
pakistani	First names & prop nouns
gaza	First names & prop nouns
awe	Valid words
portfolio	Valid words
bot	Sciency words
grass	Objects and things
shelter	Transportation?
sperm	Types of people
tub	Objects and things
stock	Valid words
haul	Valid words
junta	Types of people
physic	Sciency words
son	Types of people
rejoin	Mostly Verbs
omega	Sciency words
jurist	Types of people
sharif	More names
staff	Valid words
map	Valid words
modular	Objects and things
shawn	European languages
dust	Objects and things
harden	Mostly Verbs
overboard	Transportation?
thinner	Valid words
sumo	Valid words
emerson	More names
piper	More names
snoop	Mostly Verbs
stern	Valid words
charger	Objects and things
weird	Valid words
sheridan	More names
befor	European languages
pub	Transportation?
patrick	First names & prop nouns
bali	More names
deform	Mostly Verbs
wildcat	Transportation?
rom	First names & prop nouns
marvin	First names & prop nouns
feel	Valid words
liter	Objects and things
advisor	Types of people
pee	Mostly Verbs
roll	Mostly Verbs
sandwich	Food (ingredients)
stammer	Valid words
hurl	Mostly Verbs
fright	Valid words
fleet	Transportation?
amber	Objects and things
bust	Valid words
sal	European languages
racer	Valid words
savanna	Transportation?
add	Mostly Verbs
corp	Valid words
taken	Mostly Verbs
conan	First names & prop nouns
garth	More names
grab	Mostly Verbs
jockey	Animals
milli	Sciency words
truth	Types of people
among	Valid words
text	Valid words
truce	Valid words
fuller	Valid words
compressor	Objects and things
tract	Transportation?
vivid	Valid words
donor	Sciency words
opera	Music words
ballot	Valid words
belfast	First names & prop nouns
selena	First names & prop nouns
sacrament	Types of people
ae	European languages
africa	First names & prop nouns
miser	Types of people
optimist	Types of people
crook	Types of people
reckless	Valid words
nike	First names & prop nouns
knew	Valid words
ymca	Valid words
bel	European languages
judo	Valid words
gibson	First names & prop nouns
ginger	Food (ingredients)
foot	Transportation?
symptom	Sciency words
flag	Objects and things
dy	European languages
ed	European languages
altar	Transportation?
ninth	Valid words
poll	Valid words
hyderabad	More names
hotter	Objects and things
ipad	Objects and things
million	Valid words
dot	Objects and things
patient	Sciency words
mare	Animals
queue	Valid words
result	Valid words
contend	Valid words
weak	Valid words
scotland	More names
carolina	First names & prop nouns
bengali	More names
gabe	More names
student	Valid words
battleship	Transportation?
strikeout	Valid words
cia	First names & prop nouns
tad	Valid words
wipe	Mostly Verbs
colombia	More names
neighbor	Transportation?
alan	First names & prop nouns
leach	Objects and things
strain	Valid words
parson	Types of people
flush	Mostly Verbs
loss	Mostly Verbs
rebuild	Mostly Verbs
ex	Types of people
great	Valid words
aux	European languages
refuel	Transportation?
causeway	Transportation?
compress	Mostly Verbs
edgar	First names & prop nouns
stoke	Mostly Verbs
phil	First names & prop nouns
accord	Valid words
hazard	Valid words
driven	Valid words
dil	More names
trench	Transportation?
keen	Valid words
aero	Valid words
while	Valid words
breed	Animals
stomp	Mostly Verbs
asset	Valid words
red	Objects and things
wu	Chinese/asian languages
carpet	Transportation?
karl	More names
harder	Valid words
broadway	First names & prop nouns
portion	Valid words
third	Valid words
whether	Valid words
eng	European languages
donna	First names & prop nouns
nad	More names
put	Mostly Verbs
moroccan	More names
ago	Valid words
conqueror	Valid words
eric	First names & prop nouns
cabin	Transportation?
tom	Transportation?
lake	Transportation?
tramway	Transportation?
saint	Types of people
rose	Mostly Verbs
peel	Mostly Verbs
hiv	Sciency words
flip	Mostly Verbs
penguin	Animals
comeback	Valid words
trumpet	Music words
li	European languages
libel	Valid words
desk	Transportation?
plymouth	More names
rape	Valid words
envelop	Objects and things
drop	Mostly Verbs
lift	Mostly Verbs
webster	First names & prop nouns
boyfriend	Types of people
suffix	Valid words
zeta	Sciency words
hui	Chinese/asian languages
airport	Transportation?
buffer	Valid words
affirm	Mostly Verbs
owen	First names & prop nouns
fei	Chinese/asian languages
smart	Valid words
sad	Valid words
spokesperson	Types of people
vatican	First names & prop nouns
denver	First names & prop nouns
entrust	Mostly Verbs
fang	Objects and things
volcano	Sciency words
rag	Objects and things
softer	Valid words
part	Valid words
mclaren	First names & prop nouns
roam	Mostly Verbs
terra	European languages
seat	Valid words
backup	Mostly Verbs
robertson	More names
kernel	Objects and things
chalk	Objects and things
turmoil	Valid words
belgium	More names
holt	First names & prop nouns
israel	First names & prop nouns
lose	Mostly Verbs
beau	Types of people
lima	European languages
father	Types of people
cha	European languages
stucco	Transportation?
hoax	Valid words
java	First names & prop nouns
compassion	Valid words
messiah	Valid words
prof	Types of people
flight	Transportation?
warmer	Objects and things
racist	Types of people
jumper	Valid words
suzuki	More names
faith	Valid words
garland	Objects and things
hide	Types of people
braun	More names
pak	More names
warlock	Types of people
glasgow	More names
backyard	Transportation?
blitz	Valid words
cone	Objects and things
cafe	Transportation?
tweed	Objects and things
august	Valid words
trey	Valid words
gui	First names & prop nouns
instead	Valid words
format	Valid words
luck	Valid words
liar	Types of people
channel	Valid words
bowl	Food (ingredients)
nikki	First names & prop nouns
stroll	Mostly Verbs
diablo	More names
annoy	Types of people
clerk	Types of people
bound	Valid words
teeth	Objects and things
tibet	More names
ammonia	Objects and things
contest	Valid words
un	Valid words
crawford	First names & prop nouns
taut	Mostly Verbs
aime	More names
maya	More names
friendship	Valid words
champ	Valid words
secret	Types of people
oxford	Objects and things
xu	More names
vie	Mostly Verbs
makeup	Objects and things
timber	Objects and things
ow	European languages
waterway	Transportation?
tensor	Sciency words
norfolk	More names
ussr	More names
order	Valid words
mandolin	Music words
prevent	Mostly Verbs
aunt	Types of people
coleman	First names & prop nouns
attach	Mostly Verbs
arjun	More names
chill	Objects and things
genera	Objects and things
dice	Valid words
cornerback	Valid words
zenith	Valid words
cola	Food (ingredients)
danish	First names & prop nouns
mourn	Valid words
flashlight	Objects and things
scope	Valid words
yoga	Valid words
kitchen	Transportation?
whose	Types of people
shout	Valid words
cling	Mostly Verbs
amulet	Objects and things
rebuilt	Mostly Verbs
jade	Objects and things
amelia	More names
te	European languages
connect	Mostly Verbs
warrior	Valid words
button	Objects and things
clinton	First names & prop nouns
pro	Types of people
farm	Food (ingredients)
garlic	Food (ingredients)
magic	Valid words
antagonist	Types of people
brighten	Objects and things
madison	Valid words
mono	Valid words
strict	Valid words
toast	Food (ingredients)
throat	Objects and things
effort	Valid words
prior	Valid words
excess	Valid words
boat	Transportation?
dealt	Mostly Verbs
old	Types of people
input	Mostly Verbs
straw	Objects and things
orient	Mostly Verbs
recruit	Mostly Verbs
white	Objects and things
justin	First names & prop nouns
col	More names
kung	Chinese/asian languages
fern	Objects and things
wakefield	More names
stain	Types of people
traitor	Types of people
toe	Objects and things
grasp	Mostly Verbs
physicist	Types of people
blackmail	Types of people
nonlinear	Sciency words
parent	Valid words
over	Valid words
hard	Valid words
idaho	First names & prop nouns
alto	Music words
flu	Sciency words
lowest	Valid words
caf	Transportation?
countless	Valid words
hell	Valid words
plate	Valid words
armchair	Objects and things
prix	First names & prop nouns
sum	Valid words
hurt	Mostly Verbs
flawless	Valid words
butt	Valid words
plum	Food (ingredients)
une	European languages
mule	Animals
max	Valid words
chopper	Transportation?
sydney	First names & prop nouns
cid	Transportation?
goal	Valid words
viral	Valid words
return	Mostly Verbs
branch	Valid words
handel	More names
heaven	Types of people
jonathan	First names & prop nouns
pagan	Types of people
duel	Valid words
sherlock	More names
aura	Valid words
discuss	Valid words
panther	Animals
kumar	More names
fire	Valid words
premium	Valid words
ascent	Valid words
connecticut	First names & prop nouns
longest	Valid words
buffalo	Animals
otto	More names
dusk	Objects and things
sky	Objects and things
heal	Mostly Verbs
de	European languages
vent	Objects and things
ian	Valid words
zhang	Chinese/asian languages
sink	Transportation?
honest	Valid words
unpopular	Valid words
dictatorship	Types of people
spanish	First names & prop nouns
assign	Mostly Verbs
cosmic	Types of people
astro	Valid words
yesterday	Valid words
brotherhood	Valid words
medalist	Valid words
smallpox	Sciency words
situ	Sciency words
triad	Chinese/asian languages
steep	Valid words
length	Valid words
acronym	Valid words
libyan	More names
juno	More names
abraham	First names & prop nouns
viewpoint	Valid words
unveil	Valid words
petit	European languages
poor	Transportation?
rule	Valid words
sip	Mostly Verbs
richter	More names
lux	Sciency words
linen	Objects and things
carrot	Food (ingredients)
warner	First names & prop nouns
found	Valid words
enjoy	Mostly Verbs
fiction	Valid words
philanthropist	Types of people
past	Valid words
mortar	Objects and things
stack	Valid words
stat	Valid words
child	Types of people
guru	Types of people
pasha	Types of people
corner	Valid words
partisan	Valid words
show	Valid words
fairfax	More names
cardiac	Sciency words
secular	Types of people
leo	European languages
bolton	First names & prop nouns
kin	Types of people
hub	Transportation?
kai	Chinese/asian languages
newsweek	More names
impact	Mostly Verbs
loot	Types of people
sloop	Transportation?
unrest	Valid words
appetit	More names
spent	Mostly Verbs
comedian	Valid words
coastal	Transportation?
doctor	Sciency words
ripe	Objects and things
strip	Mostly Verbs
till	Valid words
profess	Valid words
fourteenth	Valid words
taller	Transportation?
ur	European languages
cargo	Transportation?
aston	More names
mccain	First names & prop nouns
onset	Valid words
cellular	Objects and things
suppress	Types of people
bray	Valid words
darwin	First names & prop nouns
listen	Valid words
gala	Valid words
bazaar	Transportation?
southland	Transportation?
el	More names
sunlight	Objects and things
beforehand	Valid words
reflect	Mostly Verbs
kappa	Sciency words
grew	Mostly Verbs
roland	More names
toad	Animals
squid	Animals
warship	Transportation?
us	Valid words
loco	More names
wisconsin	First names & prop nouns
use	Valid words
cayman	More names
reason	Valid words
mafia	Types of people
marion	More names
lone	Valid words
roc	More names
alma	More names
nu	European languages
canteen	Transportation?
harp	Music words
halo	Objects and things
pointless	Valid words
first	Valid words
lambert	More names
dea	European languages
calcutta	Valid words
ind	European languages
normal	Valid words
lithium	Objects and things
turbo	Transportation?
often	Valid words
grand	Valid words
gil	Chinese/asian languages
somewhat	Valid words
adorn	Objects and things
peanut	Food (ingredients)
forest	Transportation?
firefight	Transportation?
rail	Transportation?
shifter	Transportation?
politician	Types of people
dan	More names
spike	Mostly Verbs
elliott	First names & prop nouns
sargent	More names
creator	Types of people
manner	Valid words
wealthiest	Transportation?
doc	European languages
europa	More names
trolley	Transportation?
tent	Transportation?
sea	Transportation?
pike	Transportation?
exceed	Mostly Verbs
kat	More names
sucker	Mostly Verbs
crossroad	Valid words
himalayan	More names
van	Transportation?
mine	Objects and things
amalgam	Valid words
clan	Types of people
ball	Valid words
scarlett	First names & prop nouns
closer	Valid words
wang	Chinese/asian languages
slave	Types of people
kneel	Valid words
esa	European languages
stallion	Animals
lear	More names
badger	Mostly Verbs
rudder	Transportation?
oneself	Valid words
basic	Valid words
vienna	More names
breaker	Mostly Verbs
index	Valid words
joey	Animals
blood	Sciency words
ve	European languages
kang	Chinese/asian languages
network	Valid words
bad	Valid words
ah	Valid words
win	Valid words
du	European languages
truss	Objects and things
preston	First names & prop nouns
bowler	Valid words
cramp	Sciency words
cartel	Types of people
molten	Objects and things
scottish	More names
undergo	Mostly Verbs
wet	Objects and things
girlfriend	Types of people
garrison	Transportation?
waterloo	Valid words
pueblo	Transportation?
helmet	Objects and things
fe	European languages
tomb	Transportation?
less	Valid words
international	Valid words
campaign	Valid words
marker	Transportation?
eve	Valid words
latter	Valid words
mound	Valid words
oct	First names & prop nouns
becaus	European languages
surreal	Valid words
claudia	More names
out	Valid words
dodger	Types of people
shaw	First names & prop nouns
boyd	First names & prop nouns
rebrand	Valid words
hari	More names
kam	More names
allegro	Music words
britney	First names & prop nouns
kingston	More names
travers	More names
sheppard	More names
shall	Valid words
seymour	First names & prop nouns
methyl	Sciency words
express	Mostly Verbs
hopper	Objects and things
swim	Valid words
oversea	Valid words
gangster	Types of people
tokyo	First names & prop nouns
disrupt	Mostly Verbs
gore	Music words
elf	Types of people
ralph	First names & prop nouns
huey	More names
peck	Valid words
yard	Valid words
nic	European languages
persona	Valid words
version	Valid words
ava	More names
frank	Valid words
lo	Valid words
sniper	Objects and things
grit	Valid words
jensen	More names
outdoor	Transportation?
americana	Objects and things
gotta	Valid words
neat	Valid words
novella	Valid words
regal	Types of people
dare	Mostly Verbs
ribbon	Objects and things
jeep	Transportation?
rae	Chinese/asian languages
denial	Valid words
level	Valid words
mama	Types of people
neg	European languages
led	Valid words
nate	First names & prop nouns
luce	More names
popcorn	Food (ingredients)
creek	Transportation?
himself	Types of people
doubt	Valid words
invest	Mostly Verbs
annum	Valid words
bear	Mostly Verbs
darren	First names & prop nouns
nik	European languages
italian	First names & prop nouns
rex	Objects and things
ecuador	More names
nil	Valid words
constraint	Valid words
starter	Valid words
whom	Types of people
jo	European languages
compound	Sciency words
richmond	First names & prop nouns
nineteen	Valid words
vivian	More names
serbian	More names
porter	Types of people
folder	Objects and things
egg	Food (ingredients)
samurai	Types of people
nude	Objects and things
indict	Types of people
muslim	First names & prop nouns
drink	Food (ingredients)
tomorrow	Valid words
marsh	Transportation?
tone	Valid words
soldier	Transportation?
spider	Animals
in	Valid words
mister	More names
malaria	Sciency words
happier	Valid words
chevrolet	More names
jock	Types of people
rocker	Music words
pet	Animals
dawson	First names & prop nouns
clay	Objects and things
raju	More names
bu	European languages
wax	Objects and things
slain	Valid words
donovan	First names & prop nouns
steel	Objects and things
debut	Valid words
entrepreneur	Types of people
null	Valid words
stole	Types of people
argent	More names
ryu	More names
wherein	Valid words
jeff	First names & prop nouns
say	Valid words
passageway	Transportation?
nightstand	Transportation?
fan	Valid words
meal	Food (ingredients)
bikini	Objects and things
snail	Animals
sheen	Objects and things
austin	First names & prop nouns
ha	Chinese/asian languages
graphic	Objects and things
veil	Types of people
dollar	Valid words
slayer	Types of people
bassist	Music words
dev	Objects and things
glen	Transportation?
late	Valid words
rico	European languages
aim	Valid words
norman	First names & prop nouns
rook	Valid words
prefer	Valid words
recommend	Mostly Verbs
speechless	Valid words
evergreen	Objects and things
mall	Transportation?
moment	Valid words
banish	Mostly Verbs
camilla	More names
wrong	Valid words
arabian	More names
beth	First names & prop nouns
harmonica	Music words
sens	European languages
stagecoach	Transportation?
press	Valid words
towel	Objects and things
diocesan	Types of people
lifelong	Types of people
dong	Chinese/asian languages
collier	More names
fitch	First names & prop nouns
mele	More names
kwan	Chinese/asian languages
next	Valid words
ambient	Music words
bid	Valid words
pain	Valid words
slide	Mostly Verbs
simpler	Valid words
blizzard	Valid words
too	Valid words
dauphin	European languages
smaller	Valid words
brazil	First names & prop nouns
psychiatrist	Sciency words
kota	More names
deux	European languages
nonstop	Valid words
sven	First names & prop nouns
chrysler	More names
client	Valid words
inhuman	Valid words
min	European languages
overrun	Mostly Verbs
nightclub	Transportation?
kay	Chinese/asian languages
binocular	Objects and things
taylor	First names & prop nouns
quaker	More names
modernist	Types of people
tome	Valid words
cross	Valid words
sharma	More names
banana	Food (ingredients)
jong	Chinese/asian languages
elm	Objects and things
skinner	More names
owe	Valid words
overlook	Valid words
pakistan	First names & prop nouns
juan	First names & prop nouns
step	Mostly Verbs
jason	First names & prop nouns
prasad	More names
plural	Valid words
live	Mostly Verbs
useless	Valid words
dale	European languages
swipe	Mostly Verbs
geoff	First names & prop nouns
ponytail	Objects and things
build	Mostly Verbs
registrar	Types of people
prize	Valid words
toni	First names & prop nouns
kill	Mostly Verbs
plight	Valid words
urgent	Valid words
notebook	Objects and things
mandarin	Food (ingredients)
viola	Music words
mouth	Objects and things
goeth	Types of people
cy	European languages
kingdom	Types of people
strand	Objects and things
asian	First names & prop nouns
motif	Valid words
weber	First names & prop nouns
axial	Sciency words
bard	Types of people
screen	Valid words
dublin	More names
amateur	Valid words
milo	Food (ingredients)
albert	More names
demon	Types of people
wellington	More names
prop	Mostly Verbs
kaiser	European languages
social	Valid words
tornado	Valid words
underwood	More names
optic	Objects and things
soto	More names
havoc	Valid words
pearson	More names
chancellor	Types of people
nixon	First names & prop nouns
ballad	Music words
specimen	Objects and things
vodka	Food (ingredients)
kristen	First names & prop nouns
insert	Mostly Verbs
profound	Valid words
cynthia	More names
revel	Mostly Verbs
elizabeth	First names & prop nouns
rug	Transportation?
dharma	More names
children	Types of people
hill	Transportation?
window	Transportation?
warwick	More names
cheek	Objects and things
ionic	Sciency words
singular	Valid words
diploma	Valid words
rower	Valid words
finley	More names
context	Valid words
imam	Types of people
sparrow	Animals
whiskey	Food (ingredients)
water	Transportation?
stretch	Valid words
buyer	Valid words
beaver	Animals
veto	Valid words
bipolar	Sciency words
dion	More names
templar	More names
knockout	Valid words
comfort	Valid words
constant	Valid words
lyricist	Valid words
nuclei	Sciency words
shrill	Valid words
jump	Mostly Verbs
potato	Food (ingredients)
dax	More names
vermont	More names
round	Valid words
pear	Food (ingredients)
border	Transportation?
cougar	Animals
classroom	Valid words
work	Valid words
shield	Mostly Verbs
paragraph	Valid words
accomplish	Mostly Verbs
smoke	Objects and things
bred	Animals
autism	Sciency words
palestinian	First names & prop nouns
look	Valid words
mascot	Objects and things
funk	Valid words
wah	European languages
subscript	Sciency words
santana	More names
magnolia	Objects and things
bun	Food (ingredients)
serpent	Animals
asher	More names
bile	Objects and things
lineup	Valid words
said	Valid words
rhea	More names
pneumonia	Sciency words
kite	Transportation?
nathan	First names & prop nouns
drive	Valid words
captain	Valid words
derrick	Transportation?
clark	First names & prop nouns
galley	Transportation?
em	Valid words
lock	Mostly Verbs
lame	Valid words
wrap	Mostly Verbs
bro	European languages
insight	Mostly Verbs
kind	Valid words
gordon	First names & prop nouns
scan	Objects and things
royalist	Types of people
sylvia	First names & prop nouns
stool	Objects and things
bachelor	Valid words
brighton	More names
stunt	Valid words
nickelodeon	Valid words
fetch	Valid words
lair	Transportation?
siberian	More names
android	Types of people
blacksmith	Types of people
compass	Objects and things
patriot	Types of people
wanna	Valid words
leroy	More names
butter	Food (ingredients)
franklin	First names & prop nouns
goldman	More names
vidal	European languages
slack	Mostly Verbs
bucket	Valid words
airfield	Transportation?
mein	Chinese/asian languages
fair	Valid words
sue	Valid words
content	Valid words
schultz	More names
sock	Objects and things
terror	Transportation?
zipper	Objects and things
cumberland	More names
impromptu	Valid words
iv	European languages
knelt	Valid words
quad	Valid words
law	Valid words
bal	European languages
soundtrack	Music words
shelley	More names
spit	Mostly Verbs
memoir	Valid words
spat	Valid words
player	Valid words
ski	Valid words
bay	Transportation?
arch	Transportation?
underneath	Valid words
mustard	Food (ingredients)
augment	Mostly Verbs
jedi	More names
burial	Transportation?
junction	Transportation?
lord	Types of people
lester	First names & prop nouns
und	European languages
factor	Valid words
phillip	First names & prop nouns
lu	Chinese/asian languages
pump	Mostly Verbs
jenna	First names & prop nouns
consul	Types of people
hogan	Transportation?
hawaiian	More names
casket	Transportation?
andrea	First names & prop nouns
topic	Valid words
transact	Mostly Verbs
space	Valid words
ruth	First names & prop nouns
alba	Objects and things
disregard	Valid words
thu	European languages
cuba	First names & prop nouns
dex	First names & prop nouns
witch	Types of people
baronet	Types of people
nsa	European languages
qi	Sciency words
pumpkin	Food (ingredients)
czech	More names
giro	More names
bravo	Valid words
hose	Objects and things
pin	Objects and things
hampton	More names
mantra	Valid words
suspicion	Valid words
equilibrium	Valid words
marino	More names
angelina	First names & prop nouns
lend	Valid words
acclaim	Valid words
gig	Valid words
grandson	Types of people
ap	European languages
herman	First names & prop nouns
widow	Types of people
courier	Transportation?
lurch	Valid words
summer	Valid words
rock	Music words
coil	Objects and things
surveil	Mostly Verbs
bet	Valid words
hydrogen	Objects and things
pattern	Valid words
handler	Animals
iii	European languages
backlash	Valid words
lama	Types of people
partial	Valid words
pulpit	Transportation?
colder	Objects and things
attic	Objects and things
santa	More names
chu	Chinese/asian languages
shirt	Objects and things
pen	Objects and things
huang	Chinese/asian languages
mina	More names
franco	European languages
geologist	Types of people
barcelona	First names & prop nouns
duck	Animals
churchyard	Transportation?
ad	Valid words
trinidad	First names & prop nouns
keith	First names & prop nouns
perez	First names & prop nouns
piedmont	Transportation?
dune	Transportation?
arizona	First names & prop nouns
thicker	Valid words
sweep	Valid words
compliant	Mostly Verbs
latest	Valid words
gnome	Types of people
lie	Types of people
lesser	Valid words
humor	Valid words
cryptic	Valid words
whip	Mostly Verbs
upward	Valid words
wasn	Valid words
hanna	More names
colombian	More names
mesh	Objects and things
trait	Valid words
pier	Transportation?
day	Valid words
beaten	Valid words
aircraft	Transportation?
snarl	Valid words
georgian	More names
preacher	Types of people
moor	Transportation?
mum	Types of people
rosario	More names
skeptic	Types of people
dresser	Transportation?
shang	Chinese/asian languages
inflict	Mostly Verbs
telenovela	Valid words
funnel	Mostly Verbs
richer	Transportation?
pop	Music words
wa	More names
dismay	Valid words
chad	More names
date	Valid words
sharp	Valid words
belief	Valid words
edict	Valid words
inc	European languages
bryan	First names & prop nouns
wander	Mostly Verbs
benton	More names
pa	European languages
beech	Objects and things
york	First names & prop nouns
grind	Mostly Verbs
tal	European languages
somber	Valid words
famous	Valid words
mutter	Valid words
wound	Mostly Verbs
cessna	More names
loyal	Types of people
willow	Objects and things
aspect	Valid words
teas	Food (ingredients)
playground	Transportation?
award	Valid words
scissor	Objects and things
clit	Types of people
extent	Valid words
skip	Mostly Verbs
preach	Valid words
everyday	Types of people
dire	Valid words
compliment	Valid words
appendix	Valid words
neutral	Valid words
antigen	Sciency words
charlton	First names & prop nouns
laird	Types of people
dreamer	Valid words
parlor	Transportation?
lynx	Animals
torn	Mostly Verbs
na	Chinese/asian languages
vinyl	Objects and things
pseudonym	Types of people
foo	First names & prop nouns
quota	Valid words
loaf	Food (ingredients)
cyber	Sciency words
mer	European languages
harvard	First names & prop nouns
harrison	First names & prop nouns
switch	Mostly Verbs
lew	More names
sketch	Objects and things
expressway	Transportation?
reindeer	Types of people
loop	Objects and things
zhou	Chinese/asian languages
previous	Valid words
roy	First names & prop nouns
por	European languages
honor	Valid words
tanker	Transportation?
median	Valid words
hansen	First names & prop nouns
appoint	Mostly Verbs
maintain	Mostly Verbs
gather	Mostly Verbs
spectrum	Valid words
bond	Types of people
mimic	Mostly Verbs
penn	First names & prop nouns
brought	Mostly Verbs
taekwondo	Valid words
forgiven	Valid words
rout	Valid words
breakthrough	Valid words
oval	Valid words
cheat	Types of people
rama	Valid words
mayhem	Valid words
pack	More names
glad	Valid words
easier	Valid words
couldn	Valid words
shear	Sciency words
semi	Valid words
thirteen	Valid words
bat	Valid words
kathleen	First names & prop nouns
vane	Sciency words
nepal	More names
brute	Types of people
pave	Mostly Verbs
claus	More names
horn	Music words
joseph	First names & prop nouns
simplest	Valid words
sword	Objects and things
appeal	Valid words
inner	Objects and things
splinter	Types of people
detect	Mostly Verbs
somali	More names
comparison	Valid words
strongest	Valid words
lawsuit	Valid words
mae	European languages
serv	European languages
temper	Objects and things
celtic	More names
eastern	Transportation?
actual	Valid words
ate	Mostly Verbs
arboretum	Transportation?
dug	Transportation?
june	First names & prop nouns
vile	Valid words
jan	First names & prop nouns
tess	More names
cliff	Transportation?
torch	Objects and things
tsunami	Valid words
baker	Types of people
puff	Objects and things
jewel	Objects and things
contrast	Valid words
maxi	Transportation?
corn	Food (ingredients)
term	Valid words
sought	Valid words
goa	European languages
allen	First names & prop nouns
tracey	More names
leaflet	Valid words
boon	Valid words
rod	Objects and things
obstruct	Mostly Verbs
ransom	Types of people
sweat	Mostly Verbs
diana	First names & prop nouns
threshold	Valid words
amnesia	Sciency words
bracket	Valid words
morton	More names
approach	Valid words
cavern	Transportation?
antonio	First names & prop nouns
upheld	Mostly Verbs
forum	Valid words
current	Valid words
tile	Transportation?
nervous	Valid words
rotor	Sciency words
gamma	Sciency words
ballard	More names
footstep	Valid words
spirit	Valid words
retreat	Valid words
feudal	Types of people
incorrect	Valid words
convict	Types of people
helpless	Valid words
dashboard	Transportation?
rebel	Types of people
event	Valid words
vine	Food (ingredients)
runoff	Valid words
flea	Transportation?
abstract	Objects and things
mainland	Transportation?
janet	First names & prop nouns
chant	Valid words
panic	Valid words
loom	Mostly Verbs
maverick	Types of people
jimi	More names
ireland	First names & prop nouns
dolphin	Animals
slavic	More names
devote	Mostly Verbs
drummer	Music words
fbi	First names & prop nouns
courtney	First names & prop nouns
springer	Animals
brenda	First names & prop nouns
baldwin	More names
bengal	More names
victoria	First names & prop nouns
protector	Types of people
vernacular	Valid words
mural	Objects and things
heavyweight	Valid words
quartz	Objects and things
samson	More names
jefferson	First names & prop nouns
roar	Valid words
ming	Chinese/asian languages
there	Valid words
decay	Objects and things
fai	Chinese/asian languages
jog	Mostly Verbs
sidewalk	Transportation?
seed	Valid words
ee	European languages
habitat	Transportation?
saddam	First names & prop nouns
fisher	Animals
whitehead	More names
relinquish	Mostly Verbs
camera	Objects and things
chat	Valid words
gravel	Objects and things
prison	Types of people
fen	Chinese/asian languages
oversight	Valid words
guerrilla	Types of people
gurney	Objects and things
proprietor	Valid words
wade	Transportation?
mania	Valid words
lawn	Transportation?
sonata	Music words
catchment	Transportation?
unison	Valid words
barrio	Transportation?
inch	Transportation?
essay	Valid words
shaman	Types of people
marco	First names & prop nouns
given	Mostly Verbs
salmon	Animals
labyrinth	Transportation?
bought	Valid words
lennox	More names
whimper	Valid words
wrath	Valid words
bender	Sciency words
hon	More names
blanc	European languages
whore	Valid words
evangelist	Types of people
former	Types of people
star	Valid words
ware	Objects and things
laker	Transportation?
bristol	More names
canon	Valid words
lace	Objects and things
tighter	Valid words
larva	Sciency words
ventral	Sciency words
longer	Valid words
also	Valid words
lobster	Animals
dementia	Sciency words
fisherman	Animals
prohibit	Mostly Verbs
someday	Valid words
abc	European languages
prequel	Valid words
charm	Valid words
caller	Valid words
futurist	Types of people
wagner	More names
exploit	Mostly Verbs
shiver	Valid words
dealer	Valid words
three	Valid words
nano	Sciency words
island	Transportation?
choi	Chinese/asian languages
roadway	Transportation?
testament	Valid words
raleigh	More names
maze	Transportation?
intuit	Mostly Verbs
hoc	European languages
vera	First names & prop nouns
orlando	First names & prop nouns
wild	Transportation?
graze	Mostly Verbs
lei	Chinese/asian languages
litter	Objects and things
yorker	Valid words
smear	Types of people
commission	Valid words
frail	Valid words
pot	Food (ingredients)
carlton	First names & prop nouns
surrey	Transportation?
aback	Mostly Verbs
harmon	More names
rival	Valid words
whole	Valid words
nevertheless	Valid words
princeton	More names
buck	Valid words
rec	Transportation?
locker	Transportation?
chase	Valid words
sovereign	Valid words
gym	Transportation?
psalm	Types of people
turner	More names
daemon	Objects and things
here	Valid words
nero	First names & prop nouns
wasp	Sciency words
record	Valid words
goldsmith	Types of people
knee	Objects and things
soon	Valid words
april	First names & prop nouns
hanson	More names
pivot	Valid words
que	European languages
bench	Valid words
maia	First names & prop nouns
passport	Types of people
ownership	Valid words
chavez	First names & prop nouns
gaunt	Valid words
northeastern	Transportation?
titan	Valid words
einstein	More names
wear	Objects and things
wimbledon	First names & prop nouns
reform	Mostly Verbs
fungi	Sciency words
almost	Valid words
odd	Valid words
trevor	First names & prop nouns
homer	Valid words
distal	Sciency words
lookout	Valid words
greed	Valid words
pe	European languages
cool	Objects and things
biscuit	Food (ingredients)
vital	Valid words
rhino	Animals
treat	Sciency words
twin	Valid words
die	Mostly Verbs
lacey	Objects and things
playoff	Valid words
world	Valid words
far	Valid words
jack	Mostly Verbs
libretto	Valid words
sportsman	Valid words
verb	Valid words
sandal	Objects and things
chord	Objects and things
rivera	More names
keller	More names
casper	More names
place	Valid words
broker	Valid words
growth	Valid words
condom	Types of people
depth	Valid words
misunderstand	Valid words
frown	Valid words
tampa	First names & prop nouns
brick	Transportation?
hay	Food (ingredients)
agenda	Valid words
instruct	Mostly Verbs
reunion	Valid words
dens	Transportation?
ok	Valid words
calf	Objects and things
face	Mostly Verbs
flaw	Valid words
earn	Mostly Verbs
retain	Mostly Verbs
load	Valid words
stronghold	Transportation?
yun	Chinese/asian languages
jericho	First names & prop nouns
benefit	Mostly Verbs
remodel	Mostly Verbs
savannah	Transportation?
improv	Valid words
habit	Valid words
putin	More names
harley	More names
framework	Valid words
lane	Transportation?
ut	European languages
artist	Types of people
straightforward	Valid words
macro	Sciency words
caught	Mostly Verbs
invent	Mostly Verbs
valet	Transportation?
sloan	First names & prop nouns
dental	Sciency words
ponder	Valid words
concord	Valid words
gallo	European languages
abolitionist	Types of people
virgin	Types of people
hut	Transportation?
aw	European languages
hat	Objects and things
stupid	Valid words
overtook	Mostly Verbs
essex	More names
eel	Animals
stun	Valid words
vote	Valid words
ethiopia	More names
blush	Valid words
cut	Mostly Verbs
hawaii	First names & prop nouns
ink	Objects and things
pan	Objects and things
salon	Objects and things
par	Transportation?
battalion	Transportation?
overnight	Valid words
prep	Valid words
vain	Mostly Verbs
split	Valid words
bow	Mostly Verbs
semiconductor	Sciency words
lynch	Types of people
montreal	First names & prop nouns
truck	Transportation?
reign	Valid words
assassin	Types of people
insult	Types of people
transit	Transportation?
rustic	Transportation?
rev	Mostly Verbs
bequeath	Mostly Verbs
witchcraft	Types of people
comic	Valid words
werewolf	Types of people
johnson	First names & prop nouns
tight	Valid words
overgrown	Objects and things
twelfth	Valid words
patch	Mostly Verbs
inferior	Valid words
inn	Transportation?
profit	Valid words
triangular	Valid words
score	Valid words
bi	Valid words
tel	European languages
ito	Chinese/asian languages
yacht	Transportation?
jin	Chinese/asian languages
melvin	First names & prop nouns
hilt	Valid words
inning	Valid words
cinnamon	Food (ingredients)
luka	First names & prop nouns
rabbi	Types of people
sequel	Valid words
ethanol	Objects and things
yang	Chinese/asian languages
we	Valid words
where	Valid words
resin	Objects and things
cold	Objects and things
afghanistan	First names & prop nouns
eta	European languages
capcom	More names
further	Valid words
ethnic	Types of people
respect	Valid words
manifesto	Valid words
wave	Valid words
leader	Valid words
heroic	Transportation?
english	First names & prop nouns
louder	Valid words
artefact	Objects and things
thinker	Types of people
madman	Types of people
guido	More names
don	Objects and things
british	First names & prop nouns
full	Valid words
lax	Valid words
bastard	Valid words
tempt	Mostly Verbs
employ	Mostly Verbs
vessel	Transportation?
burgess	More names
aground	Transportation?
cupboard	Transportation?
puerto	More names
whi	European languages
farmer	Food (ingredients)
cloak	Types of people
dixon	More names
domain	Valid words
auburn	Objects and things
fide	European languages
slim	Mostly Verbs
pavement	Transportation?
bungalow	Transportation?
flick	Valid words
strong	Valid words
equal	Valid words
gasp	Valid words
comet	Sciency words
var	First names & prop nouns
radar	Transportation?
redesign	Objects and things
extract	Mostly Verbs
mississippi	First names & prop nouns
pope	Types of people
libertarian	Types of people
prime	Valid words
thompson	First names & prop nouns
poke	Mostly Verbs
fight	Mostly Verbs
silk	Objects and things
side	Valid words
transient	Sciency words
darker	Valid words
mba	European languages
dung	Animals
clench	Mostly Verbs
mustang	Animals
overshadow	Mostly Verbs
scar	Objects and things
stem	Mostly Verbs
pour	Mostly Verbs
liz	First names & prop nouns
lin	European languages
spoil	Mostly Verbs
micro	Sciency words
hack	Sciency words
dough	Food (ingredients)
halt	Mostly Verbs
sahara	More names
mon	European languages
sidekick	Types of people
drove	Mostly Verbs
pajama	Transportation?
checkpoint	Transportation?
float	Mostly Verbs
somerset	More names
utter	Valid words
phone	Valid words
kelsey	More names
slight	Valid words
swift	Valid words
corridor	Transportation?
owl	Animals
miami	First names & prop nouns
barb	Valid words
repay	Valid words
idol	Valid words
tay	European languages
reid	First names & prop nouns
seller	Valid words
slope	Transportation?
glee	Valid words
strive	Valid words
spark	Mostly Verbs
india	First names & prop nouns
uta	More names
tori	More names
kidney	Sciency words
cheap	Valid words
peg	Mostly Verbs
mace	Objects and things
broom	Objects and things
with	Valid words
kiev	More names
nat	European languages
manson	More names
devi	More names
treatment	Sciency words
squirrel	Animals
marko	More names
must	Valid words
ultrasound	Objects and things
jess	First names & prop nouns
nigerian	First names & prop nouns
outspoken	Types of people
joker	Valid words
breakaway	Valid words
ride	Valid words
northward	Transportation?
coward	Types of people
my	Valid words
yoo	European languages
portal	Valid words
inhibit	Mostly Verbs
kendra	More names
bombard	Mostly Verbs
cobalt	Objects and things
restless	Valid words
disconnect	Mostly Verbs
naga	More names
bingo	Valid words
cynic	Types of people
storm	Valid words
cater	Mostly Verbs
urban	Transportation?
thrash	Mostly Verbs
reopen	Mostly Verbs
smarter	Valid words
gunmen	Transportation?
stuff	Valid words
cute	Valid words
formula	Valid words
sworn	Valid words
anyway	Valid words
stop	Mostly Verbs
vest	Objects and things
tribal	Types of people
know	Valid words
imperfect	Valid words
play	Valid words
bandit	Types of people
pool	Transportation?
moonlight	Objects and things
indu	More names
papa	Types of people
skate	Valid words
proto	Valid words
pedro	More names
touch	Valid words
saber	Valid words
dorsal	Sciency words
embed	Mostly Verbs
felix	First names & prop nouns
bloc	Types of people
zach	First names & prop nouns
arabia	More names
bypass	Transportation?
buzz	Valid words
lordship	Types of people
anita	More names
travel	Valid words
wwe	First names & prop nouns
imprint	Valid words
basil	Food (ingredients)
kenya	First names & prop nouns
monk	Types of people
thailand	First names & prop nouns
shallow	Valid words
dei	European languages
noon	Valid words
kala	More names
chow	Food (ingredients)
hand	Valid words
rigor	Valid words
loft	Transportation?
frankfurt	More names
syntax	Valid words
telugu	More names
marathon	Valid words
rebound	Valid words
spectacular	Valid words
gestapo	First names & prop nouns
kyle	First names & prop nouns
just	Valid words
sewer	Transportation?
milton	More names
pouch	Objects and things
uh	Valid words
woke	Transportation?
ditch	Mostly Verbs
curios	Objects and things
dope	Food (ingredients)
modern	Valid words
fra	European languages
hors	More names
plane	Transportation?
stimuli	Sciency words
wake	Valid words
enlist	Mostly Verbs
money	Valid words
huh	Valid words
sand	Objects and things
gee	Valid words
artisan	Types of people
bitch	Valid words
wind	Valid words
rematch	Valid words
viceroy	Types of people
finland	More names
lean	Mostly Verbs
amend	Mostly Verbs
brighter	Objects and things
understand	Mostly Verbs
sant	More names
bout	Valid words
partner	Valid words
chop	Mostly Verbs
basilica	Transportation?
cardiff	First names & prop nouns
trip	Valid words
niagara	More names
finger	Objects and things
awkward	Valid words
winger	Valid words
represent	Mostly Verbs
dessert	Food (ingredients)
wine	Food (ingredients)
fu	Chinese/asian languages
nigel	First names & prop nouns
cours	More names
bitten	Mostly Verbs
dragoon	More names
ou	European languages
tasmanian	More names
allan	First names & prop nouns
manifest	Valid words
male	Types of people
la	Valid words
scoot	Mostly Verbs
holiday	Valid words
character	Types of people
edo	More names
mango	Food (ingredients)
kurdish	More names
rey	European languages
childless	Types of people
din	Valid words
ethel	More names
cpu	First names & prop nouns
geo	Valid words
chick	Types of people
debra	More names
alli	Sciency words
censorship	Valid words
ratio	Valid words
haji	More names
blanca	European languages
sound	Valid words
motel	Transportation?
obsidian	Objects and things
regatta	Transportation?
stalin	More names
socket	Objects and things
pendulum	Mostly Verbs
mental	Sciency words
mori	More names
illicit	Types of people
paranoid	Valid words
insist	Valid words
wynn	More names
wikipedia	First names & prop nouns
int	European languages
martin	First names & prop nouns
nebula	Sciency words
thwart	Mostly Verbs
avatar	Types of people
cholera	Sciency words
vivo	Sciency words
waistband	Objects and things
berlin	First names & prop nouns
bauer	More names
twain	Valid words
nope	Valid words
belong	Mostly Verbs
angel	Types of people
birmingham	First names & prop nouns
eleven	Valid words
shepard	First names & prop nouns
slaughter	Types of people
he	Types of people
mit	European languages
diner	Transportation?
ration	Valid words
medina	Transportation?
aristocrat	Types of people
harrow	Mostly Verbs
box	Valid words
chapel	Transportation?
such	Valid words
men	Types of people
boss	Types of people
catch	Mostly Verbs
posterior	Sciency words
motto	Valid words
matter	Valid words
fresco	Objects and things
empress	Types of people
center	Valid words
seal	Mostly Verbs
ion	Sciency words
margin	Valid words
shard	Objects and things
buchanan	More names
fae	More names
bird	Animals
competitor	Valid words
prayer	Types of people
understood	Mostly Verbs
mat	Objects and things
no	Valid words
acacia	Objects and things
north	Transportation?
ghetto	Transportation?
division	Valid words
much	Valid words
on	Valid words
wow	Valid words
alaska	First names & prop nouns
bellow	Valid words
feud	Valid words
spawn	Transportation?
fluent	Valid words
mara	First names & prop nouns
sacramento	First names & prop nouns
task	Valid words
instructor	Valid words
twentieth	Valid words
sigh	Valid words
aj	European languages
darkest	Valid words
shown	Valid words
power	Valid words
sierra	European languages
toy	Transportation?
firth	Transportation?
soup	Food (ingredients)
court	Valid words
newt	Animals
confess	Valid words
peterson	First names & prop nouns
spoke	Valid words
after	Valid words
ev	European languages
manual	Valid words
det	European languages
gone	Mostly Verbs
hank	First names & prop nouns
lee	European languages
migrant	Types of people
leash	Objects and things
okay	Valid words
flyer	Valid words
within	Valid words
kim	European languages
alcohol	Food (ingredients)
higher	Valid words
liam	First names & prop nouns
unfair	Valid words
foreman	Types of people
iran	First names & prop nouns
von	European languages
blanco	European languages
rise	Mostly Verbs
slab	Transportation?
napkin	Objects and things
second	Valid words
thatcher	More names
cast	Valid words
faction	Types of people
anderson	First names & prop nouns
auto	Transportation?
haley	First names & prop nouns
gloria	First names & prop nouns
expect	Valid words
central	Valid words
momma	Types of people
twitch	Valid words
builder	Types of people
tool	Valid words
theres	European languages
turret	Transportation?
spire	Transportation?
an	Valid words
sep	European languages
yale	More names
were	Valid words
width	Valid words
judgment	Valid words
jian	Chinese/asian languages
bluegrass	Music words
freshmen	Valid words
phi	Sciency words
tutor	Valid words
ai	European languages
soften	Mostly Verbs
maryland	First names & prop nouns
sunglass	Objects and things
boot	Mostly Verbs
cantor	Types of people
french	First names & prop nouns
auction	Valid words
suv	More names
englishman	More names
clever	Valid words
action	Mostly Verbs
swam	Valid words
flagship	Valid words
hawk	Animals
yong	Chinese/asian languages
threat	Valid words
colonist	Types of people
neil	First names & prop nouns
abdul	More names
lack	Valid words
labrador	Animals
anthem	Music words
momentum	Valid words
tag	Objects and things
pageant	Valid words
hawker	Transportation?
wednesday	First names & prop nouns
electro	Music words
nec	European languages
ryan	First names & prop nouns
plasma	Sciency words
lan	Chinese/asian languages
lab	Valid words
either	Valid words
receptor	Sciency words
evil	Types of people
mexican	First names & prop nouns
photograph	Objects and things
uneven	Valid words
stadium	Transportation?
pasta	Food (ingredients)
eastward	Transportation?
health	Sciency words
recount	Valid words
ever	Valid words
lay	Mostly Verbs
viii	European languages
distributor	Valid words
parliament	Valid words
racial	Types of people
news	Valid words
vers	European languages
sculpt	Valid words
orang	More names
curt	Valid words
instrument	Objects and things
detroit	First names & prop nouns
mind	Valid words
complex	Valid words
dad	Types of people
spore	Sciency words
uptown	Transportation?
hamper	Mostly Verbs
cheng	Chinese/asian languages
sentiment	Valid words
gov	First names & prop nouns
zu	European languages
ukrainian	More names
viscount	Types of people
dyer	More names
nolan	First names & prop nouns
rover	Sciency words
swollen	Objects and things
southwestern	Transportation?
montana	First names & prop nouns
virtual	Valid words
au	European languages
ol	More names
bai	More names
amiga	First names & prop nouns
these	Valid words
slam	Mostly Verbs
fitz	More names
saga	Valid words
mil	Valid words
supermarket	Transportation?
strode	Mostly Verbs
nose	Objects and things
wrench	Objects and things
abel	More names
without	Valid words
creditor	Valid words
more	Valid words
cap	Objects and things
guard	Valid words
surgeon	Sciency words
crown	Valid words
seaman	Transportation?
gaga	Valid words
companion	Types of people
railway	Transportation?
shark	Animals
teller	Types of people
devin	First names & prop nouns
radio	Valid words
morocco	More names
apron	Objects and things
heroin	Food (ingredients)
adjunct	Mostly Verbs
rim	Valid words
hoover	Mostly Verbs
bureau	Types of people
ree	European languages
circuit	Valid words
dew	Valid words
other	Valid words
notch	Objects and things
troy	First names & prop nouns
cape	Objects and things
ritual	Types of people
schneider	More names
joo	Chinese/asian languages
spine	Objects and things
ture	European languages
upper	Objects and things
crush	Mostly Verbs
head	Types of people
stagger	Mostly Verbs
shrimp	Animals
repair	Mostly Verbs
pick	Valid words
baghdad	More names
piu	More names
recess	Valid words
delhi	More names
gan	European languages
plug	Mostly Verbs
liang	Chinese/asian languages
pose	Mostly Verbs
tread	Valid words
dept	First names & prop nouns
hidden	Types of people
lizard	Animals
